,result,diff,elo,opp_elo,game_time,color,start_time,day,weekday
0,0.0,-243,869,1112,600.0,1,-204.4722222222222,2,0
1,1.0,218,973,755,600.0,0,-296.47222222222223,15,2
2,0.5,-5,975,980,600.0,1,-131.97222222222217,15,2
3,0.0,-434,949,1383,600.0,0,-135.13888888888889,16,3
4,0.0,-148,876,1024,600.0,0,-176.0277777777778,16,3
5,0.0,-164,798,962,300.0,1,-162.36111111111111,16,3
6,1.0,110,830,720,300.0,0,-105.83333333333331,17,4
7,1.0,86,917,831,600.0,0,-6.416666666666664,20,0
8,0.0,-138,881,1019,600.0,0,-170.19444444444446,20,0
9,1.0,142,920,778,600.0,1,-149.11111111111106,21,1
10,0.0,-85,892,977,600.0,1,-150.2222222222222,22,2
11,1.0,83,918,835,300.0,0,-84.58333333333331,22,2
12,0.0,-103,896,999,300.0,0,-139.9444444444444,22,2
13,1.0,-61,931,992,300.0,1,-2.9999999999999947,23,3
14,1.0,106,951,845,300.0,1,-122.44444444444441,24,4
15,0.0,-165,936,1101,300.0,1,-131.25,25,5
16,0.0,-102,915,1017,600.0,1,-241.16666666666666,25,5
17,0.0,-99,898,997,300.0,0,-154.02777777777777,27,0
18,0.0,7,876,869,300.0,0,-98.19444444444443,27,0
19,1.0,-8,898,906,600.0,1,-213.13888888888886,28,1
20,0.0,-88,883,971,600.0,0,-170.44444444444446,28,1
21,0.0,48,862,814,600.0,1,-23.44444444444443,28,1
22,0.5,44,860,816,600.0,0,-277.05555555555554,5,6
23,0.0,-90,847,937,600.0,0,-93.05555555555554,6,0
24,0.0,4,830,826,600.0,1,-160.44444444444446,7,1
25,1.0,4,846,842,180.0,1,-98.58333333333331,8,2
26,0.0,-67,833,900,180.0,1,-27.472222222222207,8,2
27,0.0,-97,821,918,600.0,0,-162.69444444444446,19,6
28,1.0,22,836,814,600.0,1,-283.75,20,0
29,0.0,17,820,803,600.0,0,-137.11111111111111,20,0
30,0.0,-32,807,839,600.0,1,-264.83333333333337,20,0
31,1.0,-23,822,845,300.0,0,-77.80555555555554,20,0
32,0.0,-30,810,840,300.0,1,-128.8333333333333,20,0
33,0.0,0,797,797,300.0,0,-144.74999999999997,20,0
34,1.0,66,807,741,600.0,0,-271.1666666666667,21,1
35,1.0,32,818,786,600.0,1,-190.02777777777774,22,2
36,0.0,-14,807,821,300.0,1,-111.94444444444443,22,2
37,1.0,82,816,734,600.0,1,-97.02777777777776,22,2
38,0.5,48,815,767,600.0,0,-211.2222222222222,23,3
39,0.0,-64,806,870,600.0,1,-134.13888888888889,23,3
40,1.0,-6,817,823,600.0,0,-65.38888888888889,26,6
41,0.0,20,806,786,600.0,1,-242.33333333333331,26,6
42,1.0,59,815,756,600.0,1,-145.0,26,6
43,0.0,-62,807,869,600.0,0,-303.6111111111111,26,6
44,0.0,-32,798,830,600.0,0,-164.94444444444443,27,0
45,1.0,30,807,777,600.0,0,-169.75,27,0
46,0.0,-64,799,863,600.0,1,-229.41666666666666,27,0
47,0.0,-56,791,847,600.0,0,-22.166666666666675,28,1
48,1.0,-78,802,880,300.0,1,-43.63888888888888,28,1
49,0.0,-54,795,849,300.0,0,-165.2222222222222,29,2
50,1.0,57,802,745,600.0,1,-306.13888888888886,29,2
51,1.0,37,810,773,600.0,0,-254.69444444444446,29,2
52,1.0,8,818,810,300.0,1,-141.6111111111111,30,3
53,0.0,-144,813,957,300.0,1,-143.22222222222223,7,4
54,0.0,-48,805,853,600.0,0,-179.52777777777774,8,5
55,0.0,4,796,792,600.0,1,-215.3611111111111,9,6
56,1.0,36,804,768,600.0,0,-102.1111111111111,11,1
57,0.0,32,795,763,600.0,0,-39.19444444444441,12,2
58,1.0,36,803,767,600.0,0,-202.69444444444443,12,2
59,1.0,1,811,810,600.0,1,-162.77777777777774,12,2
60,0.0,-20,803,823,600.0,1,-275.8333333333333,13,3
61,0.0,-81,797,878,600.0,0,-62.944444444444436,14,4
62,1.0,-28,806,834,600.0,0,-282.38888888888886,15,5
63,0.0,125,795,670,600.0,0,-119.99999999999999,15,5
64,1.0,-37,804,841,600.0,1,-170.8611111111111,16,6
65,1.0,61,811,750,600.0,1,-195.1111111111111,16,6
66,1.0,37,819,782,600.0,0,-263.66666666666663,17,0
67,1.0,48,826,778,600.0,1,-260.4166666666667,17,0
68,0.0,-44,819,863,600.0,0,-249.55555555555557,18,1
69,0.0,-113,813,926,600.0,0,-250.3611111111111,18,1
70,0.0,-2,805,807,300.0,1,-136.49999999999997,19,2
71,0.0,0,797,797,600.0,1,-296.6944444444444,20,3
72,1.0,-80,812,892,600.0,1,-122.5833333333333,21,4
73,1.0,95,822,727,600.0,0,-189.3611111111111,21,4
74,1.0,193,828,635,600.0,1,-101.47222222222221,21,4
75,1.0,8,836,828,600.0,1,-165.25000000000003,23,6
76,0.0,68,826,758,600.0,0,-323.3055555555556,23,6
77,0.0,-44,819,863,600.0,0,-208.38888888888889,24,0
78,1.0,26,827,801,600.0,1,-224.94444444444443,24,0
79,1.0,48,834,786,600.0,1,-149.6111111111111,26,2
80,1.0,-15,851,866,600.0,0,-227.91666666666666,26,2
81,1.0,-11,860,871,600.0,1,-235.16666666666666,26,2
82,1.0,-7,869,876,600.0,1,-182.55555555555557,27,3
83,0.0,29,860,831,600.0,0,-51.47222222222221,27,3
84,0.0,-93,854,947,600.0,1,-208.49999999999997,27,3
85,0.0,5,845,840,600.0,0,-331.1666666666667,27,3
86,1.0,24,853,829,600.0,1,-296.36111111111114,28,4
87,0.0,-4,845,849,600.0,0,-254.83333333333334,28,4
88,0.0,-8,837,845,600.0,0,-331.08333333333337,28,4
89,0.5,31,836,805,600.0,1,-195.49999999999997,28,4
90,0.5,26,835,809,600.0,0,-126.19444444444443,28,4
91,1.0,260,839,579,600.0,0,-172.77777777777774,28,4
92,0.0,-46,832,878,600.0,0,-172.88888888888886,28,4
93,0.0,105,819,714,600.0,1,-90.63888888888887,28,4
94,1.0,48,826,778,600.0,1,-75.22222222222221,29,5
95,0.0,-2,818,820,600.0,1,-256.94444444444446,29,5
96,0.0,-57,811,868,600.0,1,-223.13888888888883,29,5
97,1.0,-20,820,840,600.0,1,-33.1388888888889,30,6
98,0.0,-31,812,843,600.0,0,-147.02777777777777,30,6
99,0.0,-14,804,818,600.0,0,-250.25,30,6
100,0.0,9,795,786,600.0,0,-206.13888888888886,30,6
101,1.0,8,803,795,600.0,1,-173.83333333333331,30,6
102,0.0,-54,796,850,600.0,0,-47.27777777777774,30,6
103,1.0,74,803,729,600.0,0,-207.75,30,6
104,0.0,-7,795,802,600.0,1,-163.63888888888886,30,6
105,0.5,-38,796,834,600.0,1,-148.16666666666669,30,6
106,0.0,-14,788,802,600.0,0,-184.75,30,6
107,0.0,34,779,745,600.0,1,-279.3333333333333,30,6
108,0.0,7,770,763,600.0,1,-277.30555555555554,30,6
109,0.0,-86,764,850,600.0,1,-23.99999999999998,30,6
110,0.0,-14,756,770,600.0,0,-178.86111111111111,1,0
111,1.0,47,763,716,600.0,1,-285.5,1,0
112,0.0,4,754,750,600.0,0,-325.0,2,1
113,1.0,-24,763,787,600.0,0,-86.74999999999997,2,1
114,0.0,-47,756,803,600.0,0,-239.86111111111111,2,1
115,0.0,-141,751,892,600.0,1,-121.94444444444443,2,1
116,1.0,-17,760,777,600.0,1,-68.52777777777777,2,1
117,1.0,54,767,713,600.0,0,-220.13888888888889,2,1
118,0.0,-88,761,849,600.0,0,-223.72222222222217,2,1
119,0.0,93,750,657,600.0,0,-252.83333333333331,2,1
120,0.0,8,741,733,600.0,1,-199.08333333333334,3,2
121,1.0,-62,751,813,600.0,1,-37.777777777777764,3,2
122,0.0,-16,743,759,600.0,0,-159.5,3,2
123,1.0,-65,753,818,600.0,1,-101.49999999999997,3,2
124,0.5,-47,754,801,600.0,0,-145.19444444444443,4,3
125,0.0,-80,747,827,600.0,0,-316.5,4,3
126,0.0,28,738,710,600.0,1,-72.74999999999997,4,3
127,0.0,-18,730,748,600.0,1,-95.41666666666666,5,4
128,1.0,43,737,694,600.0,0,-85.4722222222222,5,4
129,1.0,14,745,731,600.0,1,-235.49999999999997,5,4
130,0.0,16,736,720,600.0,0,-234.44444444444443,5,4
131,1.0,10,744,734,600.0,1,-62.24999999999997,5,4
132,0.0,-6,736,742,600.0,0,-88.36111111111109,5,4
133,0.0,-74,729,803,600.0,1,-300.99999999999994,5,4
134,0.0,-84,723,807,600.0,0,-201.38888888888889,5,4
135,0.0,-26,715,741,600.0,1,-207.8055555555555,5,4
136,0.0,-46,708,754,600.0,0,-159.24999999999994,5,4
137,1.0,-25,717,742,600.0,0,-162.97222222222223,6,5
138,0.0,30,708,678,600.0,1,-143.75,6,5
139,1.0,78,715,637,600.0,1,-303.44444444444446,6,5
140,1.0,28,723,695,600.0,1,-260.25,6,5
141,1.0,93,729,636,600.0,0,-10.55555555555554,6,5
142,1.0,31,737,706,600.0,1,-54.38888888888886,6,5
143,1.0,-5,746,751,600.0,0,-1.1111111111110945,6,5
144,1.0,93,752,659,600.0,0,-167.3611111111111,6,5
145,0.0,-65,745,810,600.0,1,-130.1111111111111,6,5
146,0.0,-35,737,772,600.0,0,-299.25,6,5
147,0.0,9,728,719,600.0,1,-207.77777777777774,6,5
148,0.0,48,718,670,600.0,0,-318.9444444444444,7,6
149,1.0,-8,727,735,600.0,0,-183.41666666666666,7,6
150,0.0,-41,720,761,600.0,0,-304.3888888888889,7,6
151,0.0,-12,712,724,600.0,1,-287.3611111111111,7,6
152,0.0,6,703,697,600.0,1,-123.22222222222221,7,6
153,0.0,102,692,590,600.0,1,-273.3611111111111,7,6
154,1.0,0,700,700,600.0,1,-91.66666666666667,8,0
155,0.0,24,691,667,600.0,0,-187.0,8,0
156,0.5,18,691,673,600.0,1,-217.9444444444444,8,0
157,1.0,124,696,572,600.0,0,-63.111111111111086,8,0
158,1.0,36,704,668,600.0,0,-267.05555555555554,8,0
159,0.5,-26,705,731,600.0,0,-220.7222222222222,8,0
160,0.0,-41,698,739,600.0,1,-330.4166666666667,8,0
161,0.0,-13,690,703,600.0,0,-266.6111111111111,8,0
162,0.0,81,680,599,600.0,1,-155.91666666666666,8,0
163,1.0,92,686,594,600.0,1,-215.0833333333333,8,0
164,0.0,-71,679,750,600.0,0,-193.05555555555551,8,0
165,1.0,39,686,647,600.0,1,-98.1111111111111,9,1
166,1.0,104,692,588,600.0,0,-60.77777777777777,9,1
167,1.0,-40,702,742,600.0,1,-322.16666666666663,9,1
168,0.0,-71,695,766,600.0,1,-156.05555555555554,9,1
169,0.0,-26,687,713,600.0,0,-18.305555555555543,9,1
170,1.0,-25,696,721,600.0,0,-285.25,9,1
171,1.0,-7,705,712,600.0,1,-321.05555555555554,9,1
172,0.0,-53,698,751,600.0,0,-150.58333333333331,9,1
173,1.0,-71,708,779,600.0,1,-293.55555555555554,9,1
174,1.0,-4,716,720,600.0,1,-327.86111111111114,9,1
175,1.0,65,723,658,600.0,0,-163.61111111111111,9,1
176,1.0,3,731,728,600.0,1,-113.22222222222221,9,1
177,0.0,-110,725,835,600.0,0,-180.0,9,1
178,0.0,-56,718,774,600.0,0,-266.72222222222223,9,1
179,1.0,63,725,662,600.0,1,-41.74999999999997,9,1
180,1.0,-59,735,794,600.0,1,-157.55555555555554,9,1
181,0.5,-15,735,750,600.0,0,-216.16666666666669,10,2
182,0.0,-8,727,735,600.0,1,-180.25,10,2
183,0.0,-99,721,820,600.0,0,-191.25,10,2
184,1.0,2,729,727,600.0,1,-201.2222222222222,10,2
185,1.0,2,737,735,600.0,0,-22.80555555555555,10,2
186,0.0,-41,730,771,600.0,0,-114.08333333333331,10,2
187,1.0,114,736,622,600.0,1,-230.27777777777777,10,2
188,1.0,52,743,691,600.0,1,-298.91666666666663,10,2
189,0.0,33,734,701,600.0,0,-326.38888888888886,10,2
190,0.0,-20,726,746,600.0,1,-201.77777777777777,10,2
191,1.0,-20,735,755,600.0,0,-56.05555555555554,10,2
192,0.0,5,726,721,600.0,0,-101.88888888888887,10,2
193,1.0,20,734,714,600.0,1,-332.69444444444446,10,2
194,1.0,-32,743,775,600.0,1,-194.61111111111106,10,2
195,0.0,-111,737,848,600.0,1,-155.58333333333331,10,2
196,0.0,-98,731,829,600.0,1,-116.63888888888887,11,3
197,1.0,49,738,689,600.0,0,-91.52777777777776,11,3
198,0.0,40,729,689,600.0,0,-268.19444444444446,11,3
199,1.0,30,737,707,600.0,1,-93.13888888888887,11,3
200,0.0,4,728,724,600.0,0,-230.16666666666666,12,4
201,1.0,19,736,717,600.0,1,-88.63888888888886,12,4
202,0.0,2,728,726,600.0,1,-287.77777777777777,12,4
203,0.0,-104,722,826,600.0,0,-322.0555555555556,12,4
204,0.0,-80,715,795,600.0,0,-14.194444444444434,12,4
205,1.0,16,723,707,600.0,0,-239.41666666666669,13,5
206,1.0,61,730,669,600.0,1,-100.80555555555553,13,5
207,1.0,88,736,648,600.0,1,-86.7222222222222,13,5
208,1.0,-77,746,823,600.0,0,-77.2222222222222,13,5
209,0.0,-99,740,839,600.0,1,-47.55555555555553,14,6
210,0.0,-103,734,837,600.0,0,-141.19444444444446,14,6
211,0.0,-50,727,777,600.0,0,-236.41666666666663,14,6
212,0.0,48,718,670,600.0,1,-296.80555555555554,15,0
213,0.0,-70,711,781,600.0,1,-96.49999999999997,15,0
214,1.0,7,719,712,600.0,0,-267.8333333333333,15,0
215,0.5,-48,720,768,600.0,0,-316.55555555555554,15,0
216,1.0,28,728,700,600.0,0,-186.74999999999997,15,0
217,0.0,-80,721,801,600.0,1,-151.55555555555557,15,0
218,1.0,80,727,647,600.0,0,-311.55555555555554,15,0
219,0.0,-53,720,773,600.0,1,-96.02777777777776,15,0
220,1.0,-111,731,842,600.0,1,-153.05555555555551,15,0
221,1.0,-31,740,771,600.0,0,-51.44444444444445,16,1
222,1.0,27,748,721,600.0,1,-312.66666666666663,16,1
223,0.0,-49,741,790,600.0,1,-136.33333333333334,16,1
224,0.0,-55,734,789,600.0,0,-136.77777777777777,16,1
225,0.0,35,725,690,600.0,0,-248.63888888888886,16,1
226,1.0,48,732,684,600.0,0,-289.9166666666667,16,1
227,0.0,-212,727,939,600.0,1,-294.44444444444446,16,1
228,1.0,47,734,687,600.0,1,-109.88888888888886,16,1
229,1.0,39,741,702,600.0,0,-163.47222222222223,16,1
230,0.5,45,740,695,600.0,1,-246.88888888888886,16,1
231,0.0,-32,732,764,600.0,0,-299.36111111111114,16,1
232,1.0,43,739,696,600.0,0,-282.66666666666663,16,1
233,0.0,-47,732,779,600.0,1,-134.36111111111111,17,2
234,1.0,38,739,701,600.0,1,-247.75000000000003,17,2
235,1.0,48,746,698,600.0,1,-237.08333333333331,17,2
236,0.0,-27,738,765,600.0,0,-293.77777777777777,17,2
237,0.0,-65,731,796,600.0,0,-230.30555555555554,17,2
238,0.5,-104,733,837,600.0,1,-299.02777777777777,17,2
239,0.0,-138,728,866,180.0,0,-71.97222222222221,18,3
240,1.0,160,733,573,300.0,0,-49.91666666666665,18,3
241,0.0,-72,726,798,600.0,1,-249.91666666666669,18,3
242,1.0,45,733,688,600.0,1,-244.08333333333334,18,3
243,1.0,-4,741,745,600.0,0,-56.61111111111111,19,4
244,1.0,105,747,642,600.0,1,-162.88888888888889,19,4
245,0.0,-21,739,760,600.0,0,-197.1111111111111,19,4
246,0.0,22,730,708,600.0,0,-261.25,19,4
247,1.0,62,737,675,600.0,0,-30.444444444444443,19,4
248,1.0,35,745,710,600.0,1,-216.25,19,4
249,1.0,-72,755,827,600.0,1,-101.49999999999997,19,4
250,0.5,-46,756,802,600.0,0,-320.3333333333333,19,4
251,1.0,-41,765,806,300.0,1,-152.13888888888889,19,4
252,0.0,-25,757,782,300.0,0,-85.24999999999997,19,4
253,1.0,-28,766,794,300.0,1,-127.02777777777776,19,4
254,0.0,-26,758,784,600.0,0,-206.7222222222222,19,4
255,0.0,-46,751,797,600.0,1,-332.75,19,4
256,1.0,56,758,702,600.0,1,-161.24999999999997,19,4
257,0.0,-46,751,797,600.0,0,-117.91666666666664,19,4
258,1.0,-8,760,768,600.0,0,-195.25,20,5
259,1.0,30,768,738,600.0,0,-179.8611111111111,20,5
260,1.0,52,775,723,600.0,1,-236.5,20,5
261,0.0,-31,767,798,600.0,1,-256.33333333333337,21,6
262,1.0,31,775,744,600.0,1,-193.52777777777777,21,6
263,1.0,34,783,749,600.0,0,-272.02777777777777,21,6
264,1.0,159,790,631,600.0,1,-231.8333333333333,21,6
265,1.0,13,798,785,600.0,0,-180.24999999999997,21,6
266,0.0,-21,790,811,300.0,1,-139.97222222222217,21,6
267,1.0,50,797,747,300.0,1,-60.1111111111111,21,6
268,0.0,6,788,782,300.0,0,-134.9722222222222,22,0
269,1.0,-8,797,805,600.0,0,-228.5,22,0
270,0.0,27,788,761,600.0,0,-143.55555555555554,22,0
271,1.0,31,796,765,600.0,1,-112.8611111111111,22,0
272,1.0,52,803,751,600.0,0,-123.94444444444443,22,0
273,1.0,20,811,791,600.0,1,-259.4166666666667,22,0
274,1.0,14,819,805,600.0,1,-78.05555555555554,22,0
275,0.0,-3,811,814,600.0,1,-329.88888888888886,22,0
276,0.5,33,810,777,600.0,0,-296.47222222222223,23,1
277,0.0,-35,802,837,600.0,0,-155.69444444444443,23,1
278,1.0,-20,811,831,600.0,1,-243.77777777777774,23,1
279,1.0,-28,820,848,600.0,1,-169.94444444444443,23,1
280,1.0,10,828,818,600.0,0,-267.0,23,1
281,0.0,-24,820,844,600.0,0,-94.9722222222222,23,1
282,1.0,2,828,826,600.0,0,-279.13888888888886,23,1
283,0.0,41,819,778,600.0,1,-223.91666666666663,23,1
284,1.0,-4,828,832,600.0,1,-155.86111111111111,24,2
285,1.0,56,835,779,600.0,0,-131.33333333333331,24,2
286,1.0,-19,844,863,600.0,1,-121.80555555555554,24,2
287,0.0,-51,837,888,600.0,0,-248.49999999999997,24,2
288,0.0,-94,831,925,600.0,0,-123.3611111111111,24,2
289,0.0,-72,824,896,600.0,1,-203.6111111111111,24,2
290,0.0,7,815,808,600.0,1,-243.86111111111106,24,2
291,1.0,-14,824,838,600.0,1,-6.888888888888869,25,3
292,0.0,-33,816,849,600.0,0,-240.33333333333334,25,3
293,0.0,-14,808,822,600.0,0,-118.4722222222222,25,3
294,1.0,27,816,789,600.0,1,-196.33333333333331,25,3
295,0.0,-8,808,816,600.0,1,-298.91666666666663,25,3
296,0.0,19,799,780,600.0,0,-175.55555555555554,25,3
297,0.5,-69,801,870,600.0,1,-95.33333333333331,25,3
298,0.0,12,792,780,600.0,1,-167.83333333333334,25,3
299,1.0,25,800,775,600.0,0,-237.49999999999997,25,3
300,0.0,29,791,762,600.0,0,-190.16666666666663,25,3
301,0.0,-4,783,787,600.0,0,-216.58333333333334,29,0
302,1.0,34,791,757,600.0,1,-23.111111111111114,29,0
303,1.0,44,799,755,600.0,1,-17.916666666666657,29,0
304,0.0,-48,792,840,600.0,0,-151.0277777777778,29,0
305,1.0,70,799,729,600.0,0,-18.47222222222221,29,0
306,0.0,50,789,739,600.0,1,-140.47222222222223,29,0
307,1.0,64,796,732,600.0,0,-44.99999999999997,29,0
308,0.0,-6,788,794,600.0,1,-199.00000000000003,30,1
309,0.0,-171,783,954,180.0,1,-79.30555555555554,30,1
310,0.0,-69,776,845,300.0,1,-38.99999999999999,31,2
311,1.0,28,784,756,600.0,0,-328.6944444444445,31,2
312,1.0,38,791,753,600.0,0,-173.9722222222222,5,0
313,1.0,63,798,735,600.0,0,-84.91666666666664,5,0
314,1.0,-37,807,844,600.0,1,-109.63888888888889,6,1
315,0.0,68,797,729,600.0,0,-233.91666666666666,6,1
316,1.0,-2,805,807,600.0,0,-260.0833333333333,6,1
317,0.0,-34,797,831,600.0,1,-211.91666666666663,6,1
318,0.0,-64,790,854,600.0,1,-205.74999999999997,6,1
319,0.0,10,781,771,600.0,0,-165.8611111111111,7,2
320,1.0,52,788,736,600.0,1,-24.277777777777757,7,2
321,0.0,-25,780,805,600.0,1,-307.1388888888889,7,2
322,0.0,-18,772,790,600.0,1,-118.2222222222222,7,2
323,1.0,16,780,764,600.0,0,-177.25,8,3
324,1.0,155,785,630,600.0,0,-150.19444444444446,8,3
325,1.0,-1,793,794,600.0,0,-203.1111111111111,10,5
326,0.0,12,784,772,600.0,1,-214.97222222222217,10,5
327,0.5,8,784,776,600.0,0,-229.02777777777774,10,5
328,1.0,102,790,688,600.0,1,-164.58333333333331,10,5
329,0.5,21,789,768,600.0,0,-263.6388888888889,10,5
330,0.0,-47,782,829,600.0,1,-301.99999999999994,11,6
331,0.0,-107,776,883,600.0,1,-200.88888888888889,11,6
332,1.0,49,783,734,600.0,1,-274.4722222222222,11,6
333,1.0,36,791,755,600.0,0,-171.66666666666663,11,6
334,1.0,-16,800,816,600.0,0,-137.63888888888889,12,0
335,1.0,57,807,750,600.0,1,-86.38888888888887,12,0
336,0.0,-53,800,853,600.0,0,-317.9444444444444,12,0
337,1.0,-112,811,923,600.0,0,-114.1111111111111,12,0
338,1.0,49,818,769,600.0,1,-136.08333333333331,12,0
339,1.0,136,823,687,600.0,0,-161.94444444444443,12,0
340,0.0,-43,816,859,600.0,0,-240.05555555555557,12,0
341,0.0,16,807,791,600.0,0,-193.88888888888886,12,0
342,0.0,-50,800,850,600.0,1,-104.2222222222222,12,0
343,0.0,-42,793,835,600.0,1,-159.91666666666666,12,0
344,1.0,2,801,799,600.0,1,-208.33333333333331,13,1
345,1.0,31,809,778,600.0,0,-275.4166666666667,13,1
346,0.0,-46,802,848,300.0,1,-76.88888888888887,13,1
347,0.0,26,793,767,300.0,1,-73.19444444444443,13,1
348,1.0,-19,802,821,300.0,0,-133.80555555555557,13,1
349,0.0,-89,796,885,300.0,0,-164.24999999999994,13,1
350,1.0,24,804,780,300.0,0,-132.6944444444444,13,1
351,0.0,74,794,720,600.0,1,-38.027777777777764,14,2
352,1.0,88,800,712,600.0,0,-152.41666666666669,14,2
353,1.0,39,807,768,600.0,1,-62.97222222222221,14,2
354,0.0,49,797,748,600.0,0,-180.30555555555557,14,2
355,1.0,-122,808,930,600.0,0,-186.05555555555554,14,2
356,0.0,-34,800,834,600.0,1,-174.52777777777777,14,2
357,0.0,25,791,766,600.0,1,-63.44444444444442,14,2
358,1.0,-8,800,808,180.0,1,-96.97222222222221,14,2
359,0.0,5,791,786,180.0,1,-74.05555555555554,14,2
360,1.0,69,798,729,180.0,0,-87.41666666666666,14,2
361,0.5,9,798,789,600.0,0,-325.0,14,2
362,0.5,44,797,753,600.0,0,-165.38888888888886,14,2
363,0.5,-21,797,818,600.0,1,-300.8055555555556,15,3
364,0.0,-86,791,877,600.0,1,-182.91666666666666,15,3
365,0.0,18,782,764,600.0,0,-148.63888888888889,15,3
366,0.0,-44,775,819,600.0,0,-204.1111111111111,15,3
367,1.0,60,782,722,300.0,0,-134.24999999999997,15,3
368,1.0,114,788,674,300.0,1,-120.63888888888886,15,3
369,1.0,-68,798,866,300.0,1,-67.13888888888887,15,3
370,0.0,-29,790,819,300.0,1,-37.30555555555555,16,4
371,0.5,-44,791,835,300.0,1,-123.33333333333331,16,4
372,0.0,-49,784,833,300.0,0,-104.74999999999999,16,4
373,0.5,11,784,773,300.0,0,-146.86111111111111,17,5
374,1.0,112,790,678,300.0,1,-138.4722222222222,17,5
375,0.0,20,781,761,300.0,1,-77.88888888888887,17,5
376,1.0,-12,790,802,300.0,0,-57.9722222222222,18,6
377,0.0,-134,785,919,300.0,0,-132.02777777777774,18,6
378,0.0,-142,780,922,300.0,0,-118.88888888888887,18,6
379,1.0,-12,789,801,600.0,1,-60.08333333333331,18,6
380,0.0,-21,781,802,600.0,1,-233.1944444444444,18,6
381,1.0,124,786,662,300.0,0,-78.41666666666666,19,0
382,0.0,-107,780,887,300.0,1,-135.97222222222223,19,0
383,0.0,-75,773,848,300.0,1,-54.1111111111111,19,0
384,0.0,-38,766,804,600.0,0,-264.1666666666667,19,0
385,0.0,26,757,731,600.0,1,-128.75,19,0
386,1.0,59,764,705,600.0,0,-92.05555555555554,20,1
387,0.5,-20,764,784,600.0,1,-313.3055555555556,20,1
388,1.0,26,772,746,600.0,0,-291.22222222222223,20,1
389,1.0,-4,780,784,600.0,0,-175.08333333333331,20,1
390,1.0,-4,788,792,600.0,1,-184.8611111111111,20,1
391,0.0,-36,781,817,600.0,1,-135.02777777777774,20,1
392,0.0,-47,774,821,600.0,0,-203.24999999999997,20,1
393,1.0,91,780,689,600.0,1,-289.2222222222222,20,1
394,1.0,164,785,621,600.0,0,-155.05555555555554,20,1
395,0.0,20,776,756,600.0,0,-131.08333333333331,21,2
396,1.0,31,784,753,180.0,1,-94.13888888888889,21,2
397,0.0,-24,776,800,180.0,1,-94.75,21,2
398,0.0,-32,768,800,300.0,0,-91.66666666666666,21,2
399,1.0,71,775,704,300.0,1,-90.27777777777776,21,2
400,1.0,-48,784,832,300.0,0,-87.52777777777777,21,2
401,1.0,-44,793,837,300.0,0,-154.80555555555554,21,2
402,1.0,-79,803,882,300.0,1,-129.27777777777777,21,2
403,1.0,-15,812,827,300.0,0,-109.52777777777774,21,2
404,1.0,62,819,757,300.0,0,-121.80555555555554,21,2
405,0.0,108,808,700,300.0,0,-151.91666666666666,21,2
406,0.0,-108,802,910,300.0,1,-100.9722222222222,21,2
407,0.0,9,793,784,300.0,1,-123.27777777777776,21,2
408,1.0,-47,803,850,300.0,1,-150.16666666666663,21,2
409,0.0,61,793,732,300.0,1,-157.9722222222222,21,2
410,1.0,42,800,758,300.0,1,-70.44444444444443,21,2
411,0.0,-84,794,878,300.0,1,-59.583333333333314,22,3
412,1.0,-9,803,812,300.0,0,-136.74999999999997,22,3
413,0.0,-70,796,866,300.0,0,-127.74999999999997,22,3
414,0.0,-194,790,984,300.0,0,-78.27777777777779,23,4
415,0.0,-10,782,792,300.0,1,-90.91666666666667,23,4
416,0.0,-12,774,786,300.0,0,-33.583333333333336,23,4
417,1.0,-2,782,784,600.0,0,-211.72222222222223,23,4
418,0.0,-32,774,806,600.0,1,-61.27777777777776,23,4
419,1.0,45,781,736,600.0,1,-116.41666666666664,23,4
420,0.0,-59,774,833,600.0,0,-142.0,23,4
421,0.0,47,764,717,600.0,1,-164.74999999999997,23,4
422,0.0,29,755,726,600.0,1,-96.88888888888887,24,5
423,0.0,-112,749,861,600.0,1,-177.91666666666666,24,5
424,0.0,-10,741,751,600.0,1,-180.66666666666669,25,6
425,1.0,35,749,714,600.0,0,-18.194444444444425,26,0
426,1.0,32,757,725,600.0,0,-50.16666666666666,26,0
427,1.0,59,764,705,600.0,0,-121.30555555555557,27,1
428,1.0,1,772,771,600.0,1,-205.1111111111111,28,2
429,1.0,-60,782,842,600.0,0,-179.66666666666666,3,0
430,0.0,-83,776,859,600.0,1,-165.25000000000003,3,0
431,1.0,53,783,730,600.0,0,-90.7222222222222,3,0
432,1.0,-24,792,816,600.0,0,-237.49999999999997,3,0
433,1.0,-19,801,820,600.0,1,-97.27777777777777,3,0
434,1.0,22,809,787,600.0,1,-167.0,4,1
435,0.0,-59,802,861,600.0,1,-192.27777777777777,4,1
436,1.0,49,809,760,600.0,0,-37.611111111111114,4,1
437,1.0,39,816,777,600.0,0,-222.41666666666669,4,1
438,1.0,37,824,787,600.0,1,-213.91666666666666,4,1
439,1.0,-51,834,885,600.0,1,-49.666666666666636,4,1
440,0.0,-23,826,849,600.0,0,-142.0,4,1
441,0.0,-21,818,839,600.0,0,-172.16666666666666,4,1
442,1.0,103,824,721,600.0,0,-12.694444444444443,4,1
443,0.0,-45,817,862,600.0,1,-28.41666666666664,4,1
444,1.0,-18,826,844,600.0,0,-117.6111111111111,4,1
445,0.0,-93,820,913,600.0,1,-174.08333333333331,4,1
446,0.5,-4,820,824,600.0,1,-265.5,4,1
447,0.0,-89,814,903,600.0,1,-143.05555555555554,5,2
448,1.0,142,819,677,300.0,0,-98.97222222222219,5,2
449,1.0,27,827,800,300.0,1,-37.91666666666665,5,2
450,0.0,0,819,819,300.0,0,-79.19444444444443,5,2
451,0.0,53,809,756,300.0,1,-111.7222222222222,5,2
452,1.0,34,817,783,300.0,0,-18.944444444444425,5,2
453,0.0,36,808,772,300.0,0,-110.91666666666664,5,2
454,1.0,19,816,797,300.0,0,-131.4722222222222,5,2
455,0.0,-35,808,843,300.0,1,-165.83333333333334,6,3
456,0.0,-93,802,895,300.0,1,-56.55555555555554,6,3
457,1.0,67,809,742,600.0,1,-107.27777777777776,6,3
458,1.0,130,814,684,600.0,1,-183.55555555555554,7,4
459,1.0,-4,823,827,600.0,0,-148.27777777777777,7,4
460,1.0,-9,832,841,300.0,1,-130.36111111111111,7,4
461,0.0,-29,824,853,300.0,0,-135.22222222222223,7,4
462,0.0,4,815,811,600.0,0,-226.11111111111111,7,4
463,1.0,81,821,740,600.0,0,-215.3888888888889,8,5
464,1.0,60,828,768,600.0,1,-214.02777777777777,8,5
465,1.0,-45,837,882,600.0,0,-231.47222222222217,8,5
466,1.0,-32,846,878,600.0,1,-154.13888888888889,9,6
467,1.0,54,853,799,600.0,1,-53.888888888888864,9,6
468,0.0,-41,846,887,600.0,0,-226.4722222222222,9,6
469,0.0,11,837,826,600.0,1,-116.05555555555554,9,6
470,1.0,85,843,758,600.0,1,-195.80555555555551,9,6
471,1.0,50,850,800,600.0,1,-291.8333333333333,10,0
472,1.0,4,858,854,600.0,0,-250.77777777777777,10,0
473,1.0,12,866,854,600.0,0,-82.49999999999999,10,0
474,1.0,2,874,872,600.0,0,-201.77777777777777,10,0
475,1.0,40,881,841,600.0,1,-304.9166666666667,10,0
476,0.0,-7,873,880,600.0,0,-292.80555555555554,11,1
477,1.0,3,881,878,600.0,0,-316.4722222222223,11,1
478,1.0,27,889,862,600.0,1,-174.80555555555554,11,1
479,0.0,-79,882,961,600.0,1,-96.13888888888886,11,1
480,1.0,22,890,868,600.0,1,-187.52777777777774,11,1
481,1.0,65,897,832,600.0,1,-331.5,11,1
482,1.0,53,904,851,600.0,0,-11.055555555555529,11,1
483,0.0,-32,896,928,600.0,0,-107.33333333333331,11,1
484,1.0,64,903,839,600.0,0,-238.66666666666666,11,1
485,1.0,36,911,875,600.0,1,-178.16666666666666,12,2
486,0.0,-3,903,906,600.0,0,-256.77777777777777,12,2
487,1.0,42,910,868,600.0,0,-173.63888888888886,12,2
488,0.0,-12,902,914,600.0,1,-202.16666666666666,12,2
489,1.0,3,910,907,600.0,0,-209.19444444444446,12,2
490,1.0,14,918,904,600.0,1,-203.66666666666669,12,2
491,1.0,43,925,882,600.0,1,-146.25,12,2
492,1.0,24,933,909,600.0,1,-319.5,12,2
493,1.0,6,941,935,600.0,0,-193.22222222222223,13,3
494,1.0,42,948,906,600.0,1,-151.19444444444443,13,3
495,0.5,53,947,894,600.0,0,-332.80555555555554,13,3
496,0.0,8,938,930,600.0,0,-200.74999999999997,13,3
497,1.0,35,946,911,600.0,1,-48.138888888888886,14,4
498,1.0,53,953,900,600.0,0,-99.41666666666664,14,4
499,0.0,-37,946,983,600.0,0,-113.52777777777776,14,4
500,0.0,-27,938,965,600.0,1,-105.08333333333331,14,4
501,1.0,79,944,865,300.0,1,-99.22222222222221,14,4
502,0.0,50,934,884,300.0,0,-142.33333333333331,15,5
503,0.0,27,925,898,600.0,0,-130.63888888888889,15,5
504,1.0,23,933,910,600.0,1,-241.44444444444446,15,5
505,0.0,-78,926,1004,600.0,1,-182.0,15,5
506,0.0,0,918,918,600.0,1,-240.30555555555551,15,5
507,1.0,56,925,869,600.0,0,-226.9722222222222,16,6
508,0.0,-32,917,949,600.0,1,-155.69444444444443,16,6
509,1.0,-13,926,939,600.0,0,-176.80555555555551,16,6
510,0.0,57,916,859,600.0,0,-330.47222222222223,16,6
511,0.0,-7,908,915,600.0,0,-279.5833333333333,17,0
512,0.5,7,908,901,300.0,1,-165.86111111111111,17,0
513,1.0,39,915,876,300.0,0,-14.305555555555543,17,0
514,1.0,77,922,845,300.0,0,-153.08333333333334,17,0
515,0.0,-16,914,930,300.0,1,-159.22222222222223,17,0
516,0.0,-51,907,958,600.0,1,-296.75,17,0
517,1.0,54,914,860,600.0,1,-274.5,17,0
518,0.0,-30,906,936,600.0,1,-310.52777777777777,18,1
519,0.0,-60,899,959,300.0,1,-102.41666666666667,18,1
520,0.0,-47,892,939,600.0,0,-315.97222222222223,18,1
521,1.0,13,900,887,600.0,0,-253.27777777777777,18,1
522,0.0,-110,894,1004,600.0,0,-263.97222222222223,18,1
523,0.0,-19,886,905,600.0,1,-50.11111111111109,19,2
524,0.0,-28,878,906,600.0,0,-162.33333333333331,19,2
525,0.0,-70,871,941,600.0,0,-64.97222222222221,19,2
526,0.0,-42,864,906,600.0,0,-133.22222222222223,19,2
527,1.0,37,872,835,600.0,1,-260.27777777777777,20,3
528,1.0,-7,881,888,600.0,1,-239.27777777777777,20,3
529,1.0,-9,890,899,600.0,1,-256.97222222222223,20,3
530,1.0,32,898,866,600.0,1,-275.0833333333333,20,3
531,0.0,-71,891,962,600.0,1,-252.72222222222217,20,3
532,0.0,72,881,809,600.0,0,-33.666666666666664,21,4
533,0.0,-24,873,897,600.0,1,-212.08333333333331,21,4
534,1.0,106,879,773,600.0,0,-116.55555555555554,21,4
535,1.0,1,887,886,600.0,0,-292.9444444444444,22,5
536,0.0,-111,881,992,600.0,0,-139.4444444444444,22,5
537,1.0,-61,891,952,600.0,1,-143.69444444444443,23,6
538,0.5,-44,892,936,600.0,1,-317.0277777777778,23,6
539,0.5,70,890,820,600.0,0,-228.8611111111111,23,6
540,0.0,-39,883,922,600.0,0,-102.3611111111111,23,6
541,0.5,-20,884,904,600.0,1,-300.8055555555556,23,6
542,0.0,-40,877,917,600.0,1,-169.13888888888886,23,6
543,0.0,-22,869,891,600.0,1,-272.19444444444446,23,6
544,0.0,-35,861,896,600.0,1,-329.4722222222222,24,0
545,1.0,36,869,833,600.0,0,-234.69444444444443,24,0
546,0.0,-36,861,897,600.0,0,-168.41666666666663,24,0
547,1.0,-18,870,888,600.0,0,-177.11111111111111,25,1
548,1.0,-58,880,938,600.0,1,-312.22222222222223,25,1
549,1.0,42,887,845,600.0,0,-131.58333333333331,25,1
550,0.0,13,878,865,600.0,1,-260.97222222222223,25,1
551,0.5,-132,881,1013,300.0,0,-160.66666666666666,25,1
552,1.0,57,888,831,600.0,0,-90.66666666666664,25,1
553,1.0,-22,897,919,600.0,1,-250.19444444444446,26,2
554,0.0,-102,891,993,600.0,1,-64.63888888888887,26,2
555,0.0,-27,883,910,600.0,1,-107.9722222222222,27,3
556,1.0,27,891,864,600.0,0,-283.19444444444446,27,3
557,1.0,39,899,860,600.0,0,-17.138888888888886,27,3
558,1.0,78,906,828,600.0,1,-261.47222222222223,27,3
559,1.0,-17,915,932,600.0,0,-268.88888888888886,27,3
560,1.0,17,923,906,600.0,0,-82.13888888888887,28,4
561,1.0,6,931,925,600.0,1,-281.0833333333333,28,4
562,0.0,7,922,915,600.0,0,-286.6111111111111,28,4
563,0.5,-71,924,995,600.0,0,-331.55555555555554,28,4
564,0.0,-32,916,948,600.0,1,-112.77777777777777,29,5
565,0.0,19,907,888,600.0,1,-213.30555555555554,29,5
566,0.0,28,898,870,300.0,1,-137.69444444444443,29,5
567,1.0,40,907,867,600.0,0,-327.8611111111111,29,5
568,0.5,64,905,841,600.0,0,-295.8333333333333,29,5
569,0.0,-40,898,938,600.0,0,-278.55555555555554,30,6
570,0.0,-9,890,899,600.0,1,-281.3611111111111,30,6
571,0.0,-47,883,930,600.0,1,-321.36111111111114,30,6
572,0.0,30,874,844,600.0,1,-122.74999999999997,30,6
573,0.0,-2,866,868,600.0,0,-107.77777777777776,31,0
574,1.0,21,874,853,600.0,0,-177.5,31,0
575,0.0,-34,866,900,600.0,0,-284.1388888888889,31,0
576,1.0,25,874,849,600.0,1,-132.52777777777777,1,1
577,0.5,-10,874,884,600.0,1,-289.5,1,1
578,0.0,61,864,803,600.0,1,-180.83333333333334,1,1
579,0.0,15,855,840,600.0,0,-117.16666666666664,1,1
580,1.0,77,862,785,600.0,0,-51.44444444444444,1,1
581,0.0,21,853,832,600.0,0,-139.2222222222222,1,1
582,1.0,2,861,859,600.0,1,-183.86111111111111,1,1
583,1.0,-116,872,988,600.0,0,-33.111111111111114,2,2
584,1.0,-35,881,916,600.0,1,-165.99999999999997,2,2
585,1.0,-27,890,917,600.0,1,-163.86111111111114,2,2
586,0.0,-29,882,911,600.0,0,-181.13888888888889,2,2
587,1.0,100,888,788,600.0,1,-79.55555555555553,2,2
588,1.0,-28,897,925,600.0,0,-11.083333333333313,2,2
589,0.0,-49,890,939,600.0,0,-247.16666666666663,2,2
590,0.0,13,881,868,600.0,1,-325.8611111111111,2,2
591,1.0,38,888,850,600.0,0,-197.61111111111114,3,3
592,0.0,-20,880,900,600.0,0,-292.02777777777777,3,3
593,1.0,18,888,870,600.0,1,-134.52777777777777,3,3
594,0.0,14,879,865,600.0,0,-63.83333333333332,3,3
595,0.0,-68,872,940,600.0,0,-280.97222222222223,3,3
596,0.5,-21,872,893,600.0,1,-312.1111111111111,3,3
597,0.0,23,863,840,600.0,1,-174.13888888888889,4,4
598,0.0,-15,855,870,600.0,1,-230.8611111111111,4,4
599,1.0,21,863,842,600.0,0,-249.36111111111111,4,4
600,0.0,-44,855,899,600.0,1,-268.3888888888889,4,4
601,0.0,-33,847,880,600.0,1,-238.0,4,4
602,0.0,-36,839,875,600.0,0,-184.30555555555554,5,5
603,1.0,-16,848,864,600.0,1,-217.7222222222222,5,5
604,1.0,18,856,838,600.0,0,-92.49999999999999,5,5
605,1.0,56,863,807,600.0,0,-65.27777777777777,5,5
606,1.0,105,871,766,600.0,0,-254.11111111111111,5,5
607,1.0,-26,880,906,600.0,1,-329.1388888888889,5,5
608,1.0,132,885,753,600.0,1,-98.6111111111111,5,5
609,1.0,-25,894,919,600.0,1,-185.69444444444443,5,5
610,0.5,-88,896,984,600.0,0,-264.4722222222222,5,5
611,1.0,37,903,866,600.0,0,-296.1111111111111,6,6
612,1.0,1,911,910,600.0,1,-38.74999999999999,6,6
613,0.0,20,902,882,600.0,0,-144.91666666666669,6,6
614,0.5,-28,903,931,600.0,0,-290.6388888888889,6,6
615,1.0,-21,912,933,600.0,1,-311.80555555555554,6,6
616,1.0,-13,921,934,600.0,1,-226.74999999999997,7,0
617,1.0,91,927,836,600.0,1,-270.27777777777777,7,0
618,1.0,-19,936,955,600.0,0,-157.25,8,1
619,0.0,-18,928,946,600.0,0,-155.75,8,1
620,0.0,-41,921,962,600.0,1,-139.83333333333334,8,1
621,0.0,-36,914,950,600.0,0,-115.52777777777777,8,1
622,0.0,35,905,870,600.0,0,-246.58333333333331,8,1
623,1.0,28,913,885,600.0,1,-195.69444444444443,9,2
624,1.0,32,921,889,600.0,0,-289.30555555555554,9,2
625,1.0,28,929,901,300.0,0,-163.91666666666666,9,2
626,0.5,-5,929,934,300.0,0,-164.08333333333334,9,2
627,1.0,-5,938,943,600.0,0,-205.72222222222217,9,2
628,0.0,18,929,911,600.0,1,-270.3333333333333,9,2
629,0.0,21,920,899,600.0,1,-217.30555555555554,10,3
630,1.0,4,928,924,600.0,1,-97.55555555555557,10,3
631,1.0,64,935,871,600.0,1,-222.63888888888889,10,3
632,1.0,30,943,913,600.0,0,-122.1111111111111,10,3
633,1.0,-48,953,1001,600.0,0,-90.41666666666666,10,3
634,0.0,-41,946,987,600.0,1,-160.55555555555554,10,3
635,1.0,-3,954,957,600.0,0,-107.88888888888889,10,3
636,0.0,-34,946,980,600.0,0,-296.08333333333337,10,3
637,1.0,29,954,925,600.0,1,-221.61111111111106,10,3
638,0.0,-20,946,966,600.0,0,-119.3611111111111,11,4
639,0.0,-3,938,941,600.0,0,-133.1111111111111,11,4
640,1.0,-6,947,953,600.0,1,-179.8611111111111,11,4
641,0.0,-22,939,961,600.0,1,-193.41666666666666,12,5
642,1.0,-6,948,954,600.0,1,-43.05555555555555,12,5
643,1.0,-60,958,1018,600.0,1,-143.63888888888889,12,5
644,0.0,-83,952,1035,600.0,0,-148.02777777777777,12,5
645,0.0,-9,944,953,600.0,0,-34.30555555555555,12,5
646,1.0,17,952,935,600.0,0,-126.91666666666664,13,6
647,0.0,24,943,919,600.0,1,-215.66666666666666,13,6
648,0.0,-24,935,959,600.0,0,-166.0277777777778,13,6
649,0.0,-42,928,970,600.0,1,-199.05555555555554,13,6
650,0.5,15,928,913,600.0,0,-256.8333333333333,14,0
651,1.0,-39,937,976,600.0,0,-241.2222222222222,14,0
652,1.0,21,945,924,600.0,0,-205.13888888888889,14,0
653,1.0,-27,954,981,600.0,1,-8.277777777777782,14,0
654,1.0,-39,963,1002,600.0,1,-31.5833333333333,14,0
655,1.0,1,971,970,600.0,1,-67.27777777777777,14,0
656,1.0,17,979,962,600.0,0,-22.083333333333318,14,0
657,1.0,4,987,983,600.0,0,-105.41666666666664,14,0
658,0.0,-16,979,995,600.0,1,-182.19444444444446,15,1
659,1.0,-26,988,1014,600.0,1,-71.52777777777776,15,1
660,0.0,-40,981,1021,600.0,0,-325.61111111111114,15,1
661,0.0,2,973,971,600.0,0,-97.88888888888887,15,1
662,1.0,-19,982,1001,600.0,1,-237.30555555555554,15,1
663,1.0,51,989,938,600.0,0,-134.91666666666666,15,1
664,1.0,8,997,989,600.0,1,-101.41666666666664,15,1
665,0.0,63,987,924,600.0,0,-145.13888888888889,15,1
666,0.5,-23,988,1011,600.0,1,-275.02777777777777,15,1
667,0.0,-15,980,995,600.0,0,-182.61111111111111,16,2
668,0.0,-24,972,996,600.0,0,-222.41666666666669,16,2
669,1.0,36,979,943,600.0,1,-191.97222222222223,16,2
670,0.5,-14,979,993,600.0,1,-259.05555555555554,16,2
671,1.0,-6,988,994,600.0,0,-214.47222222222223,16,2
672,0.0,-30,980,1010,600.0,1,-96.80555555555554,16,2
673,0.0,-36,972,1008,300.0,1,-53.91666666666665,16,2
674,0.0,27,963,936,300.0,0,-116.13888888888887,16,2
675,1.0,37,971,934,300.0,1,-150.08333333333331,17,3
676,0.5,19,971,952,300.0,0,-115.4722222222222,17,3
677,0.0,1,963,962,600.0,0,-227.11111111111111,17,3
678,1.0,-53,973,1026,600.0,1,-291.9722222222222,17,3
679,0.0,15,964,949,600.0,0,-150.47222222222223,17,3
680,1.0,44,971,927,600.0,0,-156.4166666666666,17,3
681,1.0,77,978,901,600.0,1,-235.44444444444443,17,3
682,0.0,-32,970,1002,600.0,0,-321.13888888888886,17,3
683,0.0,-35,962,997,600.0,0,-185.63888888888889,18,4
684,0.0,-51,955,1006,600.0,1,-260.13888888888886,18,4
685,0.0,-16,947,963,600.0,1,-22.19444444444446,18,4
686,0.0,-4,939,943,600.0,1,-207.58333333333331,18,4
687,1.0,37,947,910,600.0,1,-261.05555555555554,19,5
688,1.0,-11,956,967,600.0,0,-260.3333333333333,19,5
689,1.0,-52,966,1018,300.0,0,-45.027777777777764,19,5
690,0.0,-16,957,973,300.0,0,-84.30555555555554,19,5
691,1.0,-15,966,981,300.0,1,-162.2777777777778,20,6
692,0.0,-54,959,1013,600.0,1,-187.75,20,6
693,0.0,6,950,944,600.0,1,-179.22222222222223,20,6
694,1.0,-23,959,982,600.0,0,-58.1388888888889,21,0
695,0.5,45,958,913,600.0,0,-207.69444444444446,21,0
696,0.0,-44,951,995,600.0,0,-203.22222222222223,21,0
697,0.0,-115,945,1060,300.0,1,-139.94444444444443,21,0
698,0.0,-82,939,1021,300.0,1,-85.0833333333333,21,0
699,0.0,9,930,921,600.0,1,-119.7222222222222,21,0
700,0.0,14,921,907,600.0,0,-117.66666666666666,21,0
701,0.0,-23,913,936,600.0,0,-164.02777777777777,22,1
702,0.0,5,905,900,600.0,0,-170.91666666666666,22,1
703,1.0,-3,913,916,600.0,1,-168.08333333333334,22,1
704,0.0,-10,905,915,600.0,1,-87.33333333333333,22,1
705,0.0,7,896,889,600.0,0,-118.69444444444443,22,1
706,1.0,-45,905,950,600.0,0,-48.41666666666667,23,2
707,1.0,31,913,882,600.0,0,-57.083333333333314,23,2
708,1.0,20,921,901,600.0,1,-157.22222222222223,23,2
709,1.0,35,929,894,600.0,1,-164.80555555555551,23,2
710,0.5,-13,929,942,600.0,0,-332.16666666666663,24,3
711,0.0,-15,921,936,600.0,1,-251.22222222222223,24,3
712,1.0,28,929,901,600.0,0,-303.19444444444446,24,3
713,1.0,-27,938,965,600.0,0,-1.9166666666666787,24,3
714,1.0,39,945,906,600.0,0,-101.94444444444443,24,3
715,1.0,-24,954,978,600.0,1,-318.91666666666663,24,3
716,0.5,41,953,912,600.0,1,-162.08333333333331,24,3
717,0.0,58,943,885,600.0,1,-210.47222222222223,25,4
718,1.0,21,951,930,600.0,0,-5.49999999999998,25,4
719,0.0,-86,945,1031,600.0,1,-41.4722222222222,25,4
720,0.0,26,936,910,600.0,1,-171.50000000000003,25,4
721,0.0,-82,930,1012,600.0,1,-126.33333333333331,25,4
722,0.5,-43,931,974,600.0,0,-248.41666666666666,25,4
723,0.0,-74,924,998,600.0,0,-164.83333333333331,25,4
724,1.0,23,932,909,600.0,0,-234.80555555555554,26,5
725,0.5,-1,932,933,600.0,1,-207.80555555555554,26,5
726,1.0,61,939,878,600.0,0,-238.38888888888889,26,5
727,0.0,-47,932,979,600.0,1,-254.4722222222222,26,5
728,0.0,-21,924,945,600.0,0,-313.6111111111111,26,5
729,0.0,-38,917,955,600.0,0,-164.36111111111111,26,5
730,1.0,11,925,914,600.0,1,-194.58333333333331,27,6
731,1.0,64,932,868,600.0,1,-262.41666666666663,27,6
732,0.0,-23,924,947,600.0,1,-158.5833333333333,27,6
733,1.0,36,932,896,600.0,0,-253.13888888888886,28,0
734,0.5,92,930,838,600.0,1,-289.1388888888889,28,0
735,0.0,-42,923,965,600.0,0,-187.0,28,0
736,1.0,-31,932,963,300.0,1,-119.08333333333331,29,1
737,1.0,38,939,901,300.0,0,-146.05555555555554,29,1
738,1.0,13,947,934,300.0,0,-117.27777777777776,29,1
739,0.0,48,938,890,300.0,0,-123.30555555555553,29,1
740,0.0,-93,932,1025,300.0,1,-141.41666666666663,29,1
741,1.0,99,938,839,300.0,0,-155.4722222222222,29,1
742,1.0,51,945,894,600.0,1,-167.77777777777774,29,1
743,1.0,61,952,891,600.0,1,-203.08333333333334,30,2
744,0.0,0,944,944,600.0,1,-273.25,30,2
745,0.0,-59,937,996,300.0,1,-85.33333333333333,30,2
746,0.0,-105,931,1036,300.0,1,-145.83333333333334,30,2
747,1.0,32,939,907,300.0,0,-37.05555555555555,31,3
748,1.0,151,944,793,300.0,0,-146.33333333333331,31,3
749,0.0,-2,936,938,300.0,0,-157.22222222222223,31,3
750,0.0,-7,928,935,300.0,1,-153.77777777777774,31,3
751,0.5,11,928,917,600.0,0,-281.88888888888886,31,3
752,0.0,-8,920,928,600.0,0,-162.27777777777777,31,3
753,1.0,-13,929,942,180.0,0,-15.19444444444443,1,4
754,1.0,123,934,811,180.0,1,-80.91666666666664,1,4
755,0.0,-79,928,1007,180.0,1,-97.8611111111111,2,5
756,0.0,-22,920,942,180.0,1,-87.49999999999999,2,5
757,0.0,-48,913,961,300.0,1,-136.55555555555557,2,5
758,0.0,-11,905,916,300.0,1,-139.11111111111111,2,5
759,0.0,2,897,895,600.0,0,-71.08333333333333,3,6
760,1.0,35,905,870,600.0,0,-6.8055555555555545,3,6
761,1.0,-18,914,932,600.0,1,-74.80555555555556,3,6
762,1.0,-10,923,933,600.0,0,-30.999999999999964,3,6
763,0.5,1,923,922,600.0,0,-309.36111111111114,3,6
764,0.0,57,913,856,600.0,0,-212.52777777777774,3,6
765,1.0,-20,922,942,600.0,1,-153.55555555555551,3,6
766,1.0,9,930,921,600.0,1,-94.99999999999999,3,6
767,0.0,-88,924,1012,600.0,1,-278.6666666666667,3,6
768,1.0,62,931,869,600.0,0,-129.19444444444446,4,0
769,0.0,-61,924,985,600.0,0,-281.8333333333333,4,0
770,0.0,19,915,896,600.0,1,-225.91666666666666,4,0
771,0.5,89,913,824,600.0,0,-159.41666666666666,4,0
772,0.0,76,903,827,600.0,1,-79.44444444444443,4,0
773,0.0,7,894,887,600.0,0,-143.66666666666666,4,0
774,1.0,202,898,696,180.0,1,-52.91666666666665,4,0
775,1.0,210,902,692,180.0,0,-99.63888888888889,4,0
776,0.0,-196,898,1094,180.0,1,-32.027777777777764,5,1
777,0.0,-9,890,899,180.0,0,-88.33333333333331,5,1
778,0.5,-72,892,964,180.0,1,-94.52777777777774,5,1
779,0.0,-2,884,886,180.0,0,-96.86111111111109,5,1
780,0.0,-93,878,971,300.0,0,-115.30555555555554,5,1
781,0.0,-62,871,933,300.0,1,-109.52777777777776,5,1
782,1.0,51,878,827,300.0,1,-125.22222222222221,5,1
783,0.0,-22,870,892,300.0,0,-143.9722222222222,6,2
784,1.0,-69,882,951,600.0,1,-332.0555555555556,25,5
785,0.0,-33,872,905,600.0,0,-258.80555555555554,4,0
786,0.0,-93,864,957,600.0,0,-163.80555555555557,4,0
787,1.0,73,873,800,600.0,1,-292.24999999999994,11,0
788,0.0,-1,862,863,600.0,1,-185.33333333333334,15,4
789,0.0,-45,853,898,600.0,1,-290.50000000000006,15,4
790,1.0,73,861,788,600.0,0,-168.94444444444443,15,4
791,0.0,-58,852,910,600.0,0,-282.80555555555554,16,5
792,0.0,-43,843,886,600.0,1,-265.8333333333333,16,5
793,0.5,6,843,837,600.0,1,-313.5277777777777,16,5
794,1.0,37,851,814,600.0,0,-247.8055555555555,16,5
795,0.0,25,841,816,600.0,1,-282.16666666666663,16,5
796,0.0,-27,833,860,300.0,0,-71.47222222222221,17,6
797,0.0,-8,824,832,600.0,0,-126.24999999999999,17,6
798,0.0,-101,818,919,300.0,1,-137.33333333333331,20,2
799,0.0,102,807,705,300.0,0,-101.38888888888889,20,2
800,1.0,80,814,734,600.0,1,-78.69444444444443,20,2
801,1.0,46,821,775,600.0,1,-318.86111111111114,20,2
802,1.0,-27,830,857,600.0,0,-72.77777777777776,20,2
803,0.0,-48,823,871,600.0,1,-193.88888888888889,20,2
804,1.0,-20,832,852,600.0,0,-23.58333333333331,20,2
805,0.0,-36,824,860,600.0,1,-304.77777777777777,20,2
806,0.0,-11,816,827,600.0,0,-300.0833333333333,20,2
807,0.0,-44,809,853,600.0,0,-152.38888888888886,20,2
808,1.0,36,817,781,300.0,0,-118.19444444444443,20,2
809,1.0,-7,826,833,180.0,1,-35.77777777777777,21,3
810,0.5,59,825,766,180.0,0,-86.74999999999999,21,3
811,1.0,-41,835,876,600.0,1,-140.52777777777777,21,3
812,0.0,-66,828,894,600.0,0,-207.58333333333331,21,3
813,1.0,87,835,748,600.0,1,-262.61111111111114,21,3
814,1.0,31,843,812,600.0,0,-148.97222222222217,21,3
815,1.0,-5,851,856,600.0,1,-169.83333333333331,21,3
816,0.0,-15,843,858,600.0,1,-235.52777777777774,21,3
817,0.0,-16,835,851,180.0,1,-93.13888888888887,21,3
818,0.0,-703,835,1538,180.0,0,-0.5833333333333142,21,3
819,1.0,99,841,742,600.0,0,-205.66666666666663,22,4
820,1.0,-8,850,858,600.0,1,-200.63888888888883,22,4
821,0.0,47,840,793,300.0,0,-103.77777777777777,23,5
822,1.0,95,846,751,300.0,0,-160.0,23,5
823,1.0,4,854,850,300.0,0,-46.94444444444444,23,5
824,0.0,61,844,783,300.0,1,-114.13888888888889,23,5
825,0.0,-81,838,919,600.0,1,-309.83333333333337,23,5
826,1.0,43,845,802,600.0,0,-167.58333333333331,23,5
827,0.0,-160,840,1000,300.0,1,-165.66666666666669,23,5
828,1.0,-22,849,871,300.0,1,-28.555555555555543,24,6
829,0.0,-36,842,878,300.0,0,-120.38888888888887,24,6
830,0.0,44,833,789,300.0,0,-126.16666666666666,24,6
831,0.0,-24,825,849,600.0,1,-180.9722222222222,24,6
832,1.0,12,833,821,600.0,1,-244.0555555555555,24,6
833,0.0,-51,826,877,600.0,0,-101.69444444444443,25,0
834,0.0,-29,818,847,600.0,0,-285.7222222222222,25,0
835,1.0,-92,828,920,600.0,1,-242.9722222222222,25,0
836,0.0,94,817,723,600.0,0,-269.66666666666663,26,1
837,1.0,26,825,799,600.0,1,-90.30555555555553,26,1
838,0.0,-61,818,879,600.0,1,-279.38888888888886,26,1
839,1.0,58,825,767,600.0,0,-76.5,26,1
840,0.0,4,817,813,600.0,1,-244.47222222222223,26,1
841,1.0,-30,826,856,600.0,0,-43.77777777777775,26,1
842,0.0,14,817,803,600.0,1,-134.74999999999997,26,1
843,0.0,46,808,762,600.0,0,-261.44444444444446,26,1
844,1.0,28,816,788,600.0,0,-296.72222222222223,27,2
845,1.0,-19,825,844,600.0,1,-331.27777777777777,27,2
846,0.0,-707,825,1532,300.0,0,-138.33333333333334,27,2
847,0.0,-579,824,1403,300.0,1,-155.97222222222223,27,2
848,0.0,-22,816,838,600.0,0,-193.08333333333334,27,2
849,0.0,21,807,786,600.0,0,-227.6666666666666,27,2
850,1.0,59,814,755,600.0,1,-59.611111111111086,27,2
851,1.0,-56,824,880,600.0,1,-317.8888888888889,27,2
852,1.0,-29,833,862,180.0,1,-37.63888888888888,28,3
853,1.0,163,838,675,300.0,0,-91.4722222222222,28,3
854,1.0,-120,849,969,300.0,0,-50.13888888888887,28,3
855,0.0,-153,844,997,300.0,1,-152.5,29,4
856,1.0,-41,853,894,300.0,1,-116.88888888888886,29,4
857,1.0,-53,863,916,180.0,0,-65.88888888888887,29,4
858,0.0,-88,857,945,180.0,1,-94.05555555555554,29,4
859,1.0,19,865,846,600.0,1,-191.72222222222223,29,4
860,0.0,-127,856,983,600.0,0,-255.0833333333333,29,4
861,0.0,-15,848,863,600.0,0,-260.0,30,5
862,1.0,3,856,853,600.0,0,-75.52777777777777,30,5
863,1.0,10,864,854,600.0,0,-154.44444444444443,30,5
864,0.0,-597,863,1460,300.0,1,-151.52777777777777,30,5
865,0.0,-131,858,989,600.0,1,-247.58333333333331,30,5
866,1.0,85,864,779,300.0,1,-91.86111111111111,30,5
867,0.0,-22,856,878,300.0,1,-109.52777777777774,30,5
868,0.0,-6,848,854,300.0,0,-65.75,31,6
869,1.0,4,856,852,180.0,1,-89.36111111111111,31,6
870,0.0,1,848,847,300.0,1,-110.08333333333331,31,6
871,0.5,-40,849,889,300.0,0,-145.97222222222223,31,6
872,0.0,-38,842,880,600.0,1,-195.91666666666666,31,6
873,0.0,-21,834,855,600.0,0,-230.88888888888886,31,6
874,0.0,-8,826,834,600.0,0,-208.83333333333331,1,0
875,0.0,-35,818,853,180.0,1,-89.16666666666667,1,0
876,1.0,-98,829,927,300.0,0,-24.166666666666657,1,0
877,0.0,-99,822,921,300.0,0,-35.388888888888886,1,0
878,1.0,47,829,782,600.0,1,-80.41666666666666,1,0
879,1.0,-81,839,920,180.0,1,-56.63888888888887,1,0
880,0.0,-22,831,853,600.0,1,-59.083333333333314,1,0
881,0.0,-4,823,827,600.0,0,-228.1111111111111,1,0
882,1.0,31,831,800,300.0,1,-128.58333333333331,2,1
883,0.5,72,829,757,300.0,0,-103.02777777777776,2,1
884,1.0,-14,838,852,300.0,1,-34.83333333333333,2,1
885,0.0,9,829,820,300.0,0,-161.22222222222226,2,1
886,1.0,-27,838,865,300.0,0,-122.94444444444443,2,1
887,1.0,4,846,842,300.0,0,-119.22222222222221,2,1
888,0.0,-93,840,933,300.0,1,-134.24999999999997,2,1
889,0.0,-41,833,874,300.0,1,-134.74999999999997,2,1
890,1.0,-10,842,852,300.0,0,-155.83333333333331,2,1
891,1.0,41,849,808,300.0,1,-76.1111111111111,2,1
892,1.0,23,857,834,300.0,1,-89.41666666666664,3,2
893,0.0,14,848,834,300.0,0,-138.36111111111111,3,2
894,0.0,-49,841,890,300.0,1,-147.63888888888889,3,2
895,1.0,-2,849,851,300.0,0,-143.27777777777774,3,2
896,1.0,145,854,709,300.0,0,-58.416666666666636,3,2
897,0.0,6,845,839,300.0,1,-143.24999999999997,3,2
898,0.0,-72,838,910,300.0,0,-60.11111111111111,4,3
899,0.0,-65,831,896,300.0,0,-146.5,4,3
900,0.5,61,830,769,600.0,1,-305.3888888888889,4,3
901,0.0,-44,823,867,600.0,1,-103.49999999999997,4,3
902,0.0,-63,816,879,600.0,0,-306.9722222222222,5,4
903,1.0,80,823,743,300.0,1,-59.027777777777764,5,4
904,0.0,-57,816,873,300.0,1,-110.9722222222222,5,4
905,0.0,-62,809,871,300.0,0,-81.05555555555553,5,4
906,1.0,3,817,814,600.0,1,-222.83333333333331,5,4
907,1.0,-44,826,870,300.0,0,-86.86111111111111,5,4
908,0.0,65,816,751,300.0,0,-118.66666666666666,6,5
909,1.0,153,821,668,300.0,1,-32.91666666666665,6,5
910,0.0,4,812,808,300.0,0,-130.08333333333334,6,5
911,0.0,3,804,801,600.0,1,-281.1944444444444,6,5
912,0.0,-26,796,822,600.0,0,-159.69444444444446,7,6
913,1.0,27,804,777,600.0,1,-226.55555555555551,7,6
914,0.0,50,794,744,600.0,1,-208.58333333333331,7,6
915,1.0,-6,803,809,600.0,0,-84.49999999999999,7,6
916,1.0,-15,812,827,600.0,0,-220.05555555555554,7,6
917,1.0,41,819,778,600.0,1,-64.66666666666666,8,0
918,0.0,-114,813,927,600.0,1,-118.63888888888887,8,0
919,1.0,50,820,770,600.0,1,-330.8611111111111,8,0
920,0.0,-70,813,883,600.0,0,-182.38888888888886,8,0
921,1.0,-24,822,846,600.0,0,-305.4166666666667,9,1
922,1.0,86,829,743,600.0,1,-161.91666666666663,9,1
923,0.0,81,819,738,600.0,0,-292.5,9,1
924,0.0,-105,813,918,600.0,1,-194.88888888888886,9,1
925,1.0,4,821,817,300.0,0,-88.99999999999997,10,2
926,0.0,16,812,796,600.0,1,-175.13888888888886,10,2
927,1.0,60,819,759,600.0,0,-183.02777777777777,11,3
928,0.5,52,818,766,600.0,1,-260.55555555555554,11,3
929,0.0,1,810,809,600.0,0,-287.1111111111111,11,3
930,0.0,-6,801,807,300.0,1,-140.61111111111111,11,3
931,0.0,-91,795,886,300.0,0,-118.86111111111109,11,3
932,0.0,-31,787,818,600.0,0,-225.80555555555554,12,4
933,0.0,-57,780,837,600.0,1,-155.94444444444443,13,5
934,1.0,95,786,691,600.0,0,-211.63888888888889,14,6
935,0.0,-83,780,863,600.0,1,-135.08333333333331,14,6
936,0.0,-77,773,850,600.0,1,-320.8055555555556,15,0
937,1.0,87,779,692,600.0,1,-329.1111111111111,15,0
938,0.0,-2,771,773,600.0,0,-277.27777777777777,15,0
939,1.0,-24,780,804,300.0,0,-136.38888888888889,16,1
940,0.0,-60,773,833,300.0,0,-121.16666666666667,16,1
941,1.0,116,779,663,300.0,1,-14.111111111111105,16,1
942,0.0,75,769,694,300.0,0,-75.8611111111111,16,1
943,1.0,42,777,735,300.0,0,-45.58333333333332,16,1
944,1.0,-48,786,834,300.0,1,-31.83333333333333,16,1
945,0.0,24,777,753,300.0,1,-160.5277777777778,16,1
946,1.0,89,783,694,300.0,1,-120.55555555555554,16,1
947,1.0,59,790,731,300.0,0,-30.777777777777757,16,1
948,0.5,-26,791,817,300.0,1,-142.49999999999997,16,1
949,0.0,-61,784,845,300.0,0,-126.2222222222222,16,1
950,0.0,-110,778,888,300.0,1,-155.30555555555557,17,2
951,1.0,33,786,753,300.0,0,-164.63888888888889,17,2
952,0.0,-87,780,867,300.0,0,-69.11111111111109,17,2
953,1.0,49,787,738,600.0,0,-221.05555555555551,17,2
954,1.0,56,794,738,600.0,0,-243.27777777777774,17,2
955,0.0,23,785,762,600.0,1,-160.49999999999994,17,2
956,1.0,-36,794,830,180.0,1,-19.944444444444432,18,3
957,1.0,-51,804,855,180.0,0,-33.74999999999999,18,3
958,0.0,-87,798,885,180.0,1,-91.38888888888887,18,3
959,1.0,130,803,673,180.0,1,-94.19444444444443,18,3
960,1.0,81,809,728,180.0,1,-89.44444444444443,18,3
961,1.0,-72,819,891,180.0,1,-17.25,19,4
962,0.0,12,810,798,180.0,0,-95.30555555555554,19,4
963,1.0,15,818,803,600.0,0,-63.88888888888887,19,4
964,1.0,54,825,771,600.0,0,-41.94444444444443,19,4
965,0.0,-4,817,821,300.0,1,-108.80555555555556,19,4
966,1.0,-48,827,875,300.0,0,-160.19444444444446,20,5
967,1.0,-18,836,854,600.0,1,-118.77777777777776,20,5
968,0.0,-324,834,1158,180.0,0,-94.47222222222221,20,5
969,0.0,-4,826,830,600.0,0,-190.33333333333331,20,5
970,1.0,59,833,774,600.0,1,-154.8333333333333,20,5
971,1.0,47,840,793,600.0,1,-104.44444444444444,21,6
972,1.0,9,848,839,600.0,1,-181.0,21,6
973,0.0,-729,848,1577,300.0,0,-127.49999999999999,21,6
974,1.0,-53,858,911,300.0,1,-89.6111111111111,21,6
975,0.0,-742,858,1600,300.0,0,-113.80555555555553,21,6
976,1.0,-10,867,877,600.0,0,-154.41666666666663,21,6
977,0.0,1,859,858,180.0,0,-96.08333333333331,21,6
978,0.5,30,858,828,300.0,1,-128.49999999999997,21,6
979,1.0,44,865,821,300.0,0,-130.52777777777774,21,6
980,0.0,-50,858,908,600.0,1,-294.72222222222223,21,6
981,1.0,-27,867,894,300.0,0,-71.69444444444443,22,0
982,0.0,-8,859,867,180.0,1,-15.63888888888887,22,0
983,0.0,-21,851,872,300.0,1,-147.6666666666666,22,0
984,0.0,-55,844,899,300.0,1,-164.30555555555551,22,0
985,1.0,-43,853,896,600.0,1,-66.66666666666666,22,0
986,1.0,102,859,757,600.0,1,-258.8333333333333,22,0
987,0.0,-30,851,881,600.0,0,-180.16666666666663,23,1
988,0.0,-22,843,865,600.0,0,-204.44444444444443,23,1
989,1.0,63,850,787,600.0,0,-155.91666666666663,23,1
990,1.0,50,857,807,600.0,1,-217.11111111111106,23,1
991,1.0,95,863,768,300.0,0,-90.22222222222223,24,2
992,0.0,4,854,850,300.0,0,-152.13888888888889,24,2
993,0.0,9,845,836,600.0,0,-218.99999999999997,24,2
994,0.0,19,836,817,600.0,1,-171.61111111111106,24,2
995,0.0,31,827,796,600.0,0,-216.91666666666666,24,2
996,1.0,47,834,787,600.0,1,-161.3611111111111,24,2
997,0.0,-57,827,884,180.0,1,-53.74999999999999,25,3
998,0.0,-102,821,923,300.0,1,-23.805555555555546,26,4
999,1.0,-4,830,834,300.0,1,-84.19444444444444,26,4
1000,0.0,-27,822,849,300.0,0,-144.88888888888889,26,4
1001,0.0,7,813,806,300.0,0,-144.22222222222223,26,4
1002,1.0,16,821,805,600.0,1,-58.52777777777776,26,4
1003,1.0,74,828,754,600.0,0,-160.33333333333331,26,4
1004,0.0,-16,820,836,600.0,0,-255.55555555555551,26,4
1005,0.0,-105,814,919,600.0,0,-275.02777777777777,26,4
1006,1.0,-17,823,840,600.0,1,-259.44444444444446,27,5
1007,1.0,-33,832,865,180.0,0,-88.69444444444441,27,5
1008,0.0,-30,824,854,600.0,0,-186.22222222222223,27,5
1009,1.0,-15,833,848,600.0,1,-145.02777777777777,28,6
1010,1.0,54,840,786,600.0,1,-268.6388888888889,28,6
1011,1.0,12,848,836,600.0,1,-95.58333333333333,28,6
1012,1.0,36,855,819,300.0,0,-96.19444444444443,29,0
1013,0.0,-16,847,863,300.0,1,-51.58333333333332,29,0
1014,0.0,-35,839,874,300.0,1,-165.77777777777777,29,0
1015,1.0,-74,849,923,300.0,0,-48.749999999999986,29,0
1016,0.5,26,848,822,300.0,0,-125.05555555555556,29,0
1017,0.0,8,839,831,300.0,1,-116.27777777777777,29,0
1018,0.0,12,830,818,600.0,0,-43.00000000000001,29,0
1019,0.0,-19,822,841,600.0,0,-237.38888888888886,30,1
1020,1.0,101,828,727,180.0,1,-12.527777777777768,30,1
1021,0.0,-89,822,911,180.0,0,-84.41666666666664,30,1
1022,1.0,71,829,758,600.0,1,-113.44444444444444,30,1
1023,1.0,-9,838,847,600.0,1,-270.77777777777777,31,2
1024,1.0,-39,847,886,600.0,1,-313.41666666666663,31,2
1025,1.0,14,855,841,600.0,1,-144.83333333333334,31,2
1026,0.5,47,854,807,600.0,1,-300.3611111111111,31,2
1027,1.0,48,861,813,600.0,0,-4.749999999999989,31,2
1028,1.0,160,868,708,600.0,1,-197.9722222222222,31,2
1029,0.0,-66,861,927,600.0,0,-253.77777777777774,31,2
1030,0.0,-8,853,861,600.0,0,-219.7222222222222,31,2
1031,0.0,4,844,840,600.0,0,-173.41666666666666,1,3
1032,1.0,9,852,843,600.0,1,-133.74999999999997,1,3
1033,0.0,-7,844,851,600.0,0,-211.61111111111106,1,3
1034,0.0,34,835,801,600.0,0,-4.61111111111107,1,3
1035,0.0,38,826,788,600.0,1,-220.80555555555551,1,3
1036,1.0,-23,835,858,600.0,1,-140.41666666666666,2,4
1037,1.0,5,843,838,600.0,1,-130.33333333333331,2,4
1038,1.0,-26,852,878,180.0,1,-87.02777777777777,2,4
1039,0.0,27,843,816,180.0,0,-95.80555555555553,2,4
1040,0.0,21,834,813,600.0,0,-254.80555555555551,2,4
1041,0.0,-63,827,890,600.0,1,-326.6666666666667,3,5
1042,0.0,-57,820,877,600.0,0,-291.86111111111114,3,5
1043,1.0,60,827,767,600.0,0,-54.24999999999998,3,5
1044,0.0,54,817,763,600.0,1,-131.6111111111111,3,5
1045,0.0,50,807,757,180.0,0,-48.749999999999986,3,5
1046,1.0,13,815,802,300.0,0,-159.24999999999997,3,5
1047,0.0,-59,808,867,300.0,1,-134.49999999999997,3,5
1048,0.0,-42,801,843,600.0,1,-223.4722222222222,3,5
1049,1.0,-7,810,817,600.0,1,-74.69444444444443,4,6
1050,0.0,9,801,792,600.0,0,-165.72222222222223,4,6
1051,0.0,-353,799,1152,300.0,1,-5.361111111111105,4,6
1052,1.0,65,806,741,600.0,1,-169.88888888888889,4,6
1053,0.0,-14,798,812,600.0,0,-222.47222222222217,4,6
1054,1.0,10,806,796,600.0,0,-291.41666666666663,4,6
1055,0.0,-133,801,934,600.0,0,-330.75,4,6
1056,1.0,37,808,771,600.0,1,-28.25,5,0
1057,0.0,502,793,291,180.0,0,-99.22222222222221,5,0
1058,0.0,-429,792,1221,180.0,0,-0.3888888888888797,5,0
1059,0.0,-849,792,1641,180.0,1,-72.69444444444443,5,0
1060,0.0,-366,790,1156,180.0,0,-3.388888888888881,5,0
1061,1.0,-28,799,827,600.0,1,-27.38888888888888,5,0
1062,0.0,-30,791,821,600.0,1,-131.77777777777777,5,0
1063,0.5,63,790,727,600.0,1,-212.5,6,1
1064,1.0,-18,799,817,600.0,0,-13.27777777777779,6,1
1065,0.0,-34,791,825,600.0,1,-284.0,6,1
1066,0.0,-240,788,1028,300.0,1,-146.86111111111111,6,1
1067,1.0,-3,796,799,300.0,0,-49.24999999999998,6,1
1068,0.0,23,787,764,300.0,0,-144.5,6,1
1069,0.5,-45,788,833,300.0,1,-145.44444444444446,6,1
1070,0.0,-223,784,1007,300.0,1,-158.25,6,1
1071,0.0,-350,782,1132,300.0,0,-0.02777777777777002,6,1
1072,0.0,4,773,769,180.0,0,-67.22222222222221,7,2
1073,0.5,5,773,768,600.0,1,-283.6111111111111,7,2
1074,1.0,-26,782,808,600.0,1,-87.77777777777776,7,2
1075,1.0,60,789,729,600.0,0,-25.58333333333333,7,2
1076,1.0,74,796,722,600.0,1,-273.41666666666663,7,2
1077,1.0,74,803,729,600.0,0,-297.33333333333337,7,2
1078,0.0,3,795,792,600.0,0,-151.8611111111111,7,2
1079,1.0,37,803,766,600.0,1,-246.7222222222222,7,2
1080,1.0,50,810,760,600.0,0,-243.74999999999997,8,3
1081,0.0,-51,803,854,600.0,1,-120.80555555555553,8,3
1082,1.0,86,809,723,600.0,1,-156.0277777777778,9,4
1083,0.0,43,800,757,600.0,1,-278.72222222222223,9,4
1084,1.0,58,807,749,600.0,0,-5.972222222222204,9,4
1085,0.0,5,799,794,600.0,1,-320.0,10,5
1086,1.0,-16,808,824,600.0,0,-240.1111111111111,11,6
1087,1.0,-34,817,851,600.0,1,-273.0,11,6
1088,0.0,-36,809,845,600.0,0,-331.5,11,6
1089,0.0,8,800,792,600.0,0,-142.08333333333331,11,6
1090,0.0,-17,792,809,300.0,0,-39.194444444444436,12,0
1091,1.0,11,800,789,300.0,1,-77.83333333333333,12,0
1092,0.0,-13,792,805,300.0,1,-86.88888888888887,12,0
1093,0.0,-91,786,877,600.0,0,-330.61111111111103,12,0
1094,1.0,-5,795,800,600.0,1,-87.99999999999999,12,0
1095,0.0,-21,787,808,600.0,0,-138.1111111111111,12,0
1096,1.0,81,793,712,600.0,1,-224.38888888888886,13,1
1097,1.0,50,800,750,600.0,0,-82.47222222222221,13,1
1098,0.0,-15,792,807,300.0,1,-100.74999999999999,13,1
1099,1.0,4,800,796,300.0,0,-77.33333333333331,13,1
1100,1.0,33,808,775,300.0,1,-162.13888888888889,13,1
1101,0.0,27,799,772,300.0,0,-164.58333333333331,13,1
1102,0.0,-49,792,841,600.0,1,-250.8611111111111,13,1
1103,1.0,39,799,760,600.0,1,-187.80555555555551,14,2
1104,0.0,-31,791,822,600.0,0,-193.05555555555554,14,2
1105,0.0,-68,784,852,600.0,1,-137.99999999999997,14,2
1106,0.0,47,774,727,600.0,0,-208.11111111111111,14,2
1107,0.0,-56,767,823,600.0,0,-303.4166666666667,14,2
1108,1.0,21,775,754,600.0,0,-324.27777777777777,15,3
1109,1.0,-19,784,803,600.0,0,-39.833333333333314,15,3
1110,1.0,13,792,779,600.0,1,-158.77777777777774,15,3
1111,1.0,-54,802,856,180.0,1,-52.52777777777776,15,3
1112,1.0,-12,811,823,600.0,0,-259.1944444444444,15,3
1113,1.0,-12,820,832,600.0,1,-0.3333333333333394,16,4
1114,0.0,19,811,792,600.0,1,-143.58333333333334,16,4
1115,0.0,23,802,779,600.0,0,-181.11111111111111,16,4
1116,1.0,7,810,803,600.0,0,-243.7222222222222,16,4
1117,1.0,-24,819,843,600.0,0,-149.44444444444443,16,4
1118,1.0,105,825,720,180.0,1,-36.80555555555554,16,4
1119,0.0,85,815,730,180.0,0,-89.05555555555554,16,4
1120,1.0,-6,824,830,180.0,1,-93.74999999999999,16,4
1121,1.0,-10,833,843,600.0,1,-32.47222222222221,17,5
1122,1.0,34,841,807,600.0,1,-150.94444444444446,17,5
1123,1.0,-13,850,863,600.0,0,-39.80555555555552,17,5
1124,1.0,-61,860,921,600.0,1,-172.4444444444444,17,5
1125,0.0,-63,853,916,600.0,0,-321.75,18,6
1126,1.0,-60,863,923,600.0,1,-85.63888888888887,18,6
1127,0.5,-31,864,895,180.0,0,-71.38888888888887,18,6
1128,0.0,-50,857,907,600.0,0,-138.33333333333331,18,6
1129,1.0,24,865,841,600.0,1,-119.5,19,0
1130,0.0,-56,858,914,600.0,0,-124.19444444444441,19,0
1131,1.0,35,866,831,600.0,0,-146.58333333333331,19,0
1132,0.0,-163,861,1024,600.0,1,-291.75,19,0
1133,0.0,-37,853,890,600.0,0,-205.88888888888886,19,0
1134,0.0,-26,845,871,600.0,1,-253.27777777777777,20,1
1135,1.0,-12,854,866,600.0,1,-199.80555555555554,20,1
1136,0.0,-13,846,859,600.0,0,-190.88888888888886,20,1
1137,1.0,6,854,848,600.0,1,-207.3611111111111,20,1
1138,1.0,22,862,840,600.0,1,-83.3611111111111,21,2
1139,0.0,-58,855,913,600.0,0,-152.5,21,2
1140,1.0,20,863,843,600.0,1,-236.66666666666666,21,2
1141,0.0,-37,855,892,600.0,0,-141.16666666666666,21,2
1142,1.0,2,863,861,600.0,0,-194.88888888888883,21,2
1143,1.0,71,870,799,600.0,0,-271.97222222222223,21,2
1144,1.0,-24,879,903,600.0,1,-111.99999999999999,22,3
1145,0.0,82,869,787,300.0,0,-152.11111111111111,22,3
1146,1.0,14,877,863,600.0,1,-172.11111111111106,22,3
1147,1.0,29,885,856,600.0,0,-183.16666666666666,23,4
1148,1.0,-58,895,953,600.0,1,-200.80555555555554,23,4
1149,1.0,23,903,880,600.0,1,-223.55555555555551,23,4
1150,1.0,62,910,848,600.0,1,-202.9444444444444,24,5
1151,1.0,15,918,903,600.0,0,-195.94444444444443,24,5
1152,0.0,-100,912,1012,300.0,1,-137.3333333333333,24,5
1153,0.0,9,903,894,600.0,0,-207.94444444444443,24,5
1154,1.0,48,910,862,600.0,0,-295.11111111111114,25,6
1155,0.0,27,901,874,600.0,0,-110.41666666666664,26,0
1156,1.0,90,907,817,600.0,1,-301.86111111111103,26,0
1157,0.5,19,907,888,600.0,0,-216.83333333333334,27,1
1158,1.0,55,914,859,600.0,0,-246.63888888888889,28,2
1159,1.0,63,921,858,600.0,1,-234.88888888888889,28,2
1160,0.0,-22,913,935,600.0,1,-281.7222222222222,28,2
1161,0.5,-1,913,914,600.0,1,-276.44444444444446,1,3
1162,1.0,-1,921,922,600.0,1,-331.13888888888886,1,3
1163,1.0,1,929,928,600.0,0,-270.13888888888886,1,3
1164,1.0,3,937,934,600.0,1,-172.75,1,3
1165,0.0,-25,929,954,600.0,0,-105.36111111111111,2,4
1166,1.0,36,937,901,600.0,0,-298.0,2,4
1167,1.0,8,945,937,600.0,0,-45.44444444444443,2,4
1168,1.0,63,952,889,600.0,1,-139.11111111111111,2,4
1169,1.0,10,960,950,600.0,1,-263.49999999999994,2,4
1170,0.0,-8,952,960,600.0,0,-174.16666666666663,2,4
1171,1.0,59,959,900,600.0,1,-64.16666666666666,3,5
1172,0.0,-40,952,992,600.0,1,-143.69444444444443,3,5
1173,0.0,-33,944,977,600.0,1,-244.16666666666666,4,6
1174,1.0,28,952,924,600.0,0,-75.38888888888889,5,0
1175,0.0,-31,944,975,600.0,0,-278.25,5,0
1176,0.0,-54,937,991,600.0,0,-278.3888888888889,6,1
1177,1.0,26,945,919,600.0,1,-136.30555555555554,6,1
1178,1.0,27,953,926,600.0,0,-179.83333333333331,6,1
1179,0.0,-42,946,988,600.0,1,-315.3888888888889,6,1
1180,0.0,-16,938,954,600.0,0,-111.69444444444443,6,1
1181,1.0,210,944,734,600.0,0,-69.25,7,2
1182,1.0,5,952,947,600.0,1,-212.83333333333334,7,2
1183,0.0,-31,944,975,600.0,0,-126.49999999999999,7,2
1184,0.5,22,943,921,600.0,1,-254.0,8,3
1185,1.0,83,949,866,600.0,1,-297.77777777777777,8,3
1186,0.0,2,941,939,600.0,0,-331.5833333333333,9,4
1187,1.0,-3,949,952,600.0,0,-176.27777777777777,10,5
1188,0.0,-8,941,949,600.0,1,-279.52777777777777,10,5
1189,0.0,-39,934,973,600.0,1,-182.0,11,6
1190,1.0,110,940,830,600.0,1,-250.66666666666666,12,0
1191,0.0,8,931,923,600.0,0,-169.7777777777778,12,0
1192,1.0,10,939,929,600.0,1,-301.4722222222223,13,1
1193,0.0,-54,932,986,600.0,0,-56.33333333333332,13,1
1194,0.0,-68,925,993,600.0,1,-230.16666666666666,13,1
1195,1.0,-69,935,1004,600.0,0,-103.91666666666664,13,1
1196,0.5,35,934,899,600.0,0,-306.72222222222223,14,2
1197,0.5,44,933,889,600.0,1,-308.75,14,2
1198,0.0,-104,927,1031,600.0,0,-82.05555555555553,14,2
1199,0.0,-36,920,956,600.0,0,-127.16666666666666,15,3
1200,1.0,17,928,911,600.0,1,-258.0833333333333,16,4
1201,0.5,-3,928,931,600.0,1,-290.8055555555556,16,4
1202,1.0,16,936,920,600.0,1,-87.88888888888889,17,5
1203,0.0,-21,928,949,600.0,1,-225.2222222222222,17,5
1204,0.0,-10,920,930,600.0,0,-191.24999999999997,17,5
1205,1.0,-31,929,960,600.0,0,-83.3611111111111,17,5
1206,0.0,53,919,866,600.0,0,-28.666666666666632,17,5
1207,1.0,-3,927,930,600.0,1,-183.8611111111111,17,5
1208,0.0,-14,919,933,600.0,0,-163.08333333333334,18,6
1209,0.0,21,910,889,600.0,0,-154.08333333333334,18,6
1210,0.0,-13,902,915,300.0,1,-128.94444444444446,18,6
1211,1.0,0,910,910,300.0,0,-138.91666666666666,18,6
1212,1.0,86,916,830,300.0,1,-104.52777777777776,18,6
1213,1.0,13,924,911,600.0,1,-305.94444444444446,18,6
1214,0.0,-15,916,931,600.0,1,-115.16666666666666,19,0
1215,0.5,-25,917,942,600.0,0,-253.52777777777774,19,0
1216,0.0,-74,910,984,300.0,0,-143.36111111111111,20,1
1217,0.0,21,901,880,600.0,0,-331.36111111111114,21,2
1218,1.0,-17,910,927,600.0,1,-211.88888888888886,22,3
1219,0.0,-6,902,908,600.0,0,-274.05555555555554,22,3
1220,0.0,9,893,884,600.0,1,-197.5,22,3
1221,1.0,60,900,840,600.0,0,-92.72222222222223,23,4
1222,0.5,0,900,900,600.0,0,-306.1111111111111,23,4
1223,1.0,-6,909,915,600.0,1,-282.55555555555554,24,5
1224,0.0,2,901,899,600.0,1,-283.6944444444444,25,6
1225,0.0,-27,893,920,600.0,0,-159.83333333333331,25,6
1226,1.0,-4,902,906,600.0,1,-44.44444444444443,26,0
1227,1.0,-31,911,942,600.0,0,-31.63888888888887,26,0
1228,0.0,-33,903,936,600.0,0,-301.25,26,0
1229,0.0,4,894,890,600.0,1,-95.77777777777774,26,0
1230,1.0,-16,903,919,600.0,0,-293.41666666666663,26,0
1231,0.0,-10,895,905,600.0,0,-275.75,27,1
1232,0.0,18,886,868,600.0,0,-273.41666666666663,27,1
1233,1.0,27,894,867,600.0,1,-177.41666666666669,28,2
1234,1.0,-30,903,933,600.0,1,-318.9444444444444,28,2
1235,1.0,-14,912,926,600.0,1,-123.27777777777776,28,2
1236,1.0,36,920,884,600.0,0,-82.9722222222222,29,3
1237,0.0,-7,912,919,600.0,0,-86.6111111111111,29,3
1238,1.0,34,920,886,600.0,1,-192.13888888888889,29,3
1239,1.0,36,927,891,600.0,0,-272.19444444444446,30,4
1240,1.0,-3,935,938,600.0,1,-168.9722222222222,30,4
1241,1.0,5,943,938,600.0,0,-61.16666666666665,30,4
1242,1.0,55,950,895,600.0,1,-168.08333333333334,31,5
1243,1.0,37,958,921,600.0,1,-317.66666666666663,31,5
1244,0.0,-32,950,982,600.0,0,-301.47222222222223,1,6
1245,1.0,-5,959,964,600.0,1,-273.6666666666667,1,6
1246,1.0,1,967,966,600.0,1,-321.38888888888886,1,6
1247,1.0,20,975,955,600.0,0,-105.0833333333333,2,0
1248,0.0,-70,968,1038,600.0,1,-194.44444444444443,3,1
1249,0.0,-34,960,994,600.0,0,-133.75,3,1
1250,1.0,31,968,937,600.0,1,-131.16666666666666,3,1
1251,1.0,-1,976,977,300.0,0,-68.72222222222221,3,1
1252,0.0,18,967,949,600.0,0,-171.99999999999997,4,2
1253,0.0,-38,960,998,600.0,0,-188.11111111111111,5,3
1254,0.5,21,959,938,600.0,1,-255.3611111111111,5,3
1255,0.0,-60,952,1012,600.0,1,-121.83333333333333,6,4
1256,0.0,-40,945,985,600.0,0,-88.05555555555556,10,1
1257,1.0,40,952,912,600.0,0,-62.3611111111111,10,1
1258,0.0,-31,944,975,600.0,1,-229.5,10,1
1259,0.0,-30,936,966,600.0,1,-39.138888888888864,10,1
1260,0.0,-26,928,954,600.0,1,-124.63888888888887,10,1
1261,0.5,-21,929,950,600.0,1,-208.16666666666666,10,1
1262,0.5,17,929,912,600.0,0,-228.30555555555557,10,1
1263,1.0,-23,938,961,600.0,0,-153.55555555555551,11,2
1264,0.0,27,929,902,600.0,0,-149.7222222222222,11,2
1265,0.0,-18,921,939,600.0,1,-281.63888888888886,12,3
1266,1.0,13,929,916,600.0,0,-301.27777777777777,13,4
1267,0.0,20,920,900,600.0,1,-304.52777777777777,13,4
1268,0.0,47,911,864,600.0,0,-167.13888888888889,14,5
1269,0.0,-60,904,964,600.0,1,-302.77777777777777,15,6
1270,1.0,-25,913,938,600.0,0,-171.52777777777777,15,6
1271,1.0,50,920,870,600.0,0,-226.02777777777774,15,6
1272,0.0,-63,913,976,600.0,1,-329.69444444444446,15,6
1273,0.0,-27,905,932,300.0,0,-128.27777777777777,15,6
1274,0.0,-54,898,952,300.0,1,-68.33333333333331,15,6
1275,1.0,-3,906,909,300.0,0,-124.9722222222222,15,6
1276,0.0,27,897,870,300.0,1,-106.24999999999999,15,6
1277,0.0,-97,891,988,600.0,0,-267.5,15,6
1278,1.0,6,899,893,600.0,1,-113.08333333333331,16,0
1279,1.0,92,905,813,600.0,0,-137.02777777777777,16,0
1280,1.0,-17,914,931,600.0,1,-1.694444444444444,16,0
1281,0.0,-5,906,911,600.0,0,-144.86111111111111,16,0
1282,1.0,95,912,817,600.0,1,-327.3611111111111,16,0
1283,1.0,30,920,890,600.0,0,-99.08333333333331,16,0
1284,1.0,73,927,854,600.0,0,-124.74999999999999,17,1
1285,1.0,-25,936,961,600.0,0,-121.66666666666664,17,1
1286,1.0,-32,945,977,600.0,1,-162.69444444444446,17,1
1287,1.0,-12,954,966,300.0,1,-127.0,18,2
1288,0.0,44,945,901,300.0,1,-138.16666666666669,18,2
1289,1.0,31,953,922,600.0,0,-220.25,18,2
1290,1.0,11,961,950,600.0,1,-44.99999999999999,19,3
1291,1.0,54,968,914,600.0,0,-215.49999999999997,19,3
1292,0.0,17,959,942,300.0,0,-86.27777777777777,19,3
1293,1.0,39,966,927,600.0,1,-129.61111111111111,19,3
1294,0.0,-41,959,1000,600.0,0,-244.30555555555551,19,3
1295,1.0,33,967,934,600.0,0,-33.1111111111111,19,3
1296,1.0,56,974,918,300.0,0,-109.9722222222222,20,4
1297,0.0,-67,967,1034,300.0,1,-95.55555555555554,20,4
1298,0.0,-98,961,1059,600.0,1,-322.41666666666663,20,4
1299,1.0,132,968,836,600.0,1,-197.91666666666663,20,4
1300,0.0,-56,961,1017,600.0,1,-97.77777777777776,22,6
1301,1.0,-28,970,998,600.0,0,-49.75,22,6
1302,1.0,45,977,932,300.0,1,-117.9722222222222,22,6
1303,0.0,5,968,963,600.0,1,-222.25,22,6
1304,0.0,21,959,938,600.0,0,-152.13888888888889,22,6
1305,1.0,26,967,941,600.0,1,-91.2222222222222,23,0
1306,0.0,-38,960,998,600.0,0,-218.41666666666666,23,0
1307,0.5,31,959,928,600.0,0,-297.7222222222223,23,0
1308,1.0,59,966,907,300.0,1,-92.02777777777777,23,0
1309,0.0,-86,960,1046,300.0,0,-78.58333333333331,23,0
1310,1.0,35,968,933,600.0,1,-153.55555555555554,23,0
1311,0.5,33,967,934,600.0,0,-159.27777777777777,23,0
1312,1.0,58,974,916,600.0,1,-145.83333333333334,24,1
1313,1.0,2,982,980,300.0,1,-102.16666666666666,24,1
1314,0.0,-14,974,988,300.0,0,-60.13888888888888,24,1
1315,1.0,2,982,980,300.0,1,-14.22222222222221,24,1
1316,0.0,41,973,932,600.0,1,-194.19444444444446,24,1
1317,0.0,-27,965,992,300.0,0,-166.44444444444446,24,1
1318,0.0,-2,957,959,300.0,1,-113.08333333333333,24,1
1319,0.0,-36,950,986,600.0,0,-152.75,24,1
1320,0.0,9,941,932,600.0,0,-208.36111111111106,24,1
1321,0.0,-54,934,988,600.0,0,-184.72222222222223,25,2
1322,0.0,10,925,915,300.0,1,-137.19444444444446,25,2
1323,0.0,27,916,889,300.0,0,-151.16666666666669,25,2
1324,0.0,-43,909,952,180.0,1,-38.694444444444436,25,2
1325,0.0,-58,902,960,300.0,1,-165.25,25,2
1326,0.0,-47,895,942,300.0,0,-94.1111111111111,25,2
1327,1.0,-10,904,914,300.0,1,-157.91666666666666,25,2
1328,1.0,19,912,893,600.0,0,-199.24999999999997,25,2
1329,0.0,-44,905,949,600.0,0,-242.41666666666669,25,2
1330,1.0,38,912,874,600.0,1,-167.83333333333331,25,2
1331,1.0,27,920,893,600.0,0,-149.22222222222223,26,3
1332,0.0,-50,913,963,600.0,0,-162.4722222222222,26,3
1333,1.0,48,920,872,600.0,1,-142.19444444444443,26,3
1334,1.0,59,927,868,600.0,1,-75.80555555555554,26,3
1335,1.0,-11,936,947,600.0,1,-327.1111111111111,26,3
1336,0.0,-41,929,970,600.0,0,-305.0833333333333,26,3
1337,0.0,16,920,904,600.0,0,-13.027777777777755,26,3
1338,0.0,2,912,910,600.0,1,-322.8888888888889,26,3
1339,0.0,-100,906,1006,300.0,1,-140.3611111111111,27,4
1340,0.0,-48,899,947,300.0,0,-165.77777777777777,27,4
1341,0.0,-15,891,906,600.0,0,-77.19444444444443,27,4
1342,1.0,-78,901,979,600.0,0,-222.80555555555551,27,4
1343,1.0,5,909,904,300.0,1,-58.88888888888888,27,4
1344,0.5,5,909,904,300.0,0,-137.25,27,4
1345,0.0,-1,901,902,600.0,1,-194.63888888888889,27,4
1346,0.0,-44,894,938,600.0,1,-143.13888888888889,27,4
1347,0.0,-37,887,924,600.0,0,-145.3611111111111,28,5
1348,1.0,44,894,850,300.0,1,-136.38888888888889,28,5
1349,1.0,-2,902,904,300.0,0,-160.77777777777777,28,5
1350,0.0,-88,896,984,600.0,0,-92.63888888888887,28,5
1351,0.0,-60,889,949,600.0,0,-199.8611111111111,28,5
1352,1.0,51,896,845,600.0,1,-276.77777777777777,29,6
1353,0.0,-42,889,931,600.0,0,-247.41666666666669,29,6
1354,1.0,33,897,864,300.0,1,-143.16666666666663,29,6
1355,0.0,-41,890,931,300.0,1,-147.19444444444443,30,0
1356,0.0,21,881,860,300.0,0,-157.5,30,0
1357,0.0,6,872,866,600.0,1,-152.83333333333334,30,0
1358,0.0,-63,865,928,300.0,1,-123.22222222222221,30,0
1359,1.0,19,873,854,300.0,0,-106.7222222222222,30,0
1360,0.5,-45,874,919,600.0,0,-240.19444444444443,30,0
1361,0.5,18,874,856,300.0,1,-131.19444444444446,1,1
1362,1.0,84,880,796,300.0,0,-13.277777777777771,1,1
1363,1.0,9,888,879,300.0,0,-152.75,1,1
1364,0.0,-30,880,910,300.0,1,-145.47222222222223,1,1
1365,0.0,-25,872,897,300.0,0,-135.5,2,2
1366,0.5,-20,873,893,300.0,1,-127.88888888888887,2,2
1367,0.0,-40,866,906,300.0,0,-131.63888888888889,2,2
1368,1.0,41,873,832,300.0,1,-39.61111111111109,2,2
1369,1.0,-43,882,925,300.0,1,-129.88888888888889,2,2
1370,0.0,-8,874,882,300.0,0,-98.55555555555553,2,2
1371,0.0,-75,867,942,300.0,1,-114.9722222222222,2,2
1372,0.0,-123,861,984,300.0,0,-93.7222222222222,2,2
1373,0.0,28,852,824,300.0,1,-131.0,3,3
1374,1.0,-17,861,878,600.0,1,-224.30555555555554,3,3
1375,0.5,-24,862,886,600.0,0,-322.75,3,3
1376,1.0,16,870,854,300.0,0,-154.41666666666666,3,3
1377,1.0,-48,879,927,300.0,1,-163.02777777777777,3,3
1378,1.0,69,886,817,600.0,0,-252.1111111111111,3,3
1379,1.0,-22,895,917,600.0,0,-203.86111111111106,3,3
1380,1.0,57,902,845,600.0,1,-274.6111111111111,3,3
1381,1.0,-12,911,923,600.0,1,-165.80555555555554,4,4
1382,0.0,-18,903,921,600.0,1,-74.7222222222222,4,4
1383,0.0,-16,895,911,600.0,0,-93.08333333333333,4,4
1384,0.5,-27,896,923,600.0,1,-193.77777777777774,4,4
1385,1.0,14,904,890,600.0,0,-236.30555555555557,4,4
1386,0.0,2,896,894,300.0,0,-154.19444444444443,4,4
1387,0.0,-11,888,899,600.0,1,-76.44444444444443,4,4
1388,1.0,11,896,885,300.0,1,-123.05555555555554,4,4
1389,0.0,-55,889,944,300.0,0,-73.77777777777777,4,4
1390,0.0,-41,882,923,600.0,0,-248.30555555555554,5,5
1391,0.0,15,873,858,600.0,1,-76.02777777777776,5,5
1392,1.0,80,880,800,600.0,1,-154.69444444444443,5,5
1393,1.0,128,885,757,600.0,0,-197.77777777777774,5,5
1394,0.5,20,885,865,600.0,1,-310.4722222222222,5,5
1395,1.0,14,893,879,600.0,1,-294.66666666666663,5,5
1396,1.0,-23,902,925,600.0,0,-45.61111111111109,6,6
1397,1.0,59,909,850,600.0,0,-213.22222222222223,6,6
1398,1.0,19,917,898,600.0,1,-154.5,6,6
1399,0.0,-35,909,944,600.0,1,-217.9444444444444,6,6
1400,0.0,-7,901,908,600.0,0,-119.08333333333333,6,6
1401,0.0,-9,893,902,600.0,0,-252.99999999999994,6,6
1402,1.0,29,901,872,600.0,0,-56.527777777777764,6,6
1403,1.0,56,908,852,600.0,1,-162.5833333333333,6,6
1404,1.0,41,915,874,600.0,0,-169.63888888888886,6,6
1405,0.5,-32,916,948,600.0,0,-186.7222222222222,6,6
1406,0.0,39,907,868,600.0,1,-262.6111111111111,7,0
1407,0.5,-16,907,923,600.0,1,-142.05555555555557,7,0
1408,0.0,-90,901,991,600.0,0,-256.27777777777777,7,0
1409,1.0,143,906,763,180.0,1,-47.166666666666664,7,0
1410,0.0,-59,899,958,180.0,1,-70.4722222222222,7,0
1411,1.0,29,907,878,180.0,0,-88.97222222222221,7,0
1412,1.0,-16,916,932,180.0,1,-20.805555555555546,7,0
1413,0.0,-4,908,912,180.0,0,-72.05555555555553,7,0
1414,0.0,-74,901,975,300.0,0,-112.80555555555554,7,0
1415,1.0,1,909,908,300.0,1,-109.24999999999997,7,0
1416,1.0,-56,919,975,180.0,0,-98.7222222222222,7,0
1417,1.0,29,927,898,180.0,0,-77.61111111111109,7,0
1418,0.0,-33,919,952,180.0,0,-75.83333333333331,8,1
1419,0.0,13,910,897,180.0,1,-48.972222222222214,8,1
1420,1.0,79,917,838,180.0,1,-38.416666666666664,8,1
1421,0.0,59,907,848,180.0,0,-97.2222222222222,8,1
1422,1.0,-11,916,927,180.0,0,-28.749999999999986,8,1
1423,1.0,14,924,910,180.0,1,-94.27777777777776,8,1
1424,0.0,2,916,914,180.0,1,-70.08333333333331,8,1
1425,0.0,1,908,907,180.0,0,-97.19444444444441,8,1
1426,1.0,-24,917,941,180.0,1,-25.833333333333318,8,1
1427,1.0,25,925,900,180.0,1,-98.02777777777776,8,1
1428,0.0,25,916,891,180.0,0,-75.4722222222222,8,1
1429,0.0,-28,908,936,180.0,1,-91.3333333333333,8,1
1430,0.0,3,899,896,600.0,0,-140.74999999999997,8,1
1431,0.0,-4,891,895,600.0,0,-239.83333333333334,9,2
1432,1.0,-40,900,940,180.0,1,-86.88888888888887,9,2
1433,1.0,-9,909,918,180.0,0,-42.55555555555554,9,2
1434,0.5,-26,910,936,600.0,1,-241.0,9,2
1435,0.0,-64,903,967,180.0,0,-82.13888888888887,9,2
1436,1.0,57,910,853,600.0,1,-316.41666666666663,9,2
1437,0.0,16,901,885,300.0,0,-159.61111111111106,9,2
1438,0.0,-34,893,927,600.0,1,-177.19444444444443,10,3
1439,1.0,20,901,881,180.0,1,-97.9722222222222,10,3
1440,0.0,-3,893,896,180.0,1,-36.8611111111111,10,3
1441,1.0,22,901,879,180.0,0,-91.63888888888887,10,3
1442,1.0,12,909,897,180.0,0,-87.19444444444443,10,3
1443,0.0,-24,901,925,180.0,0,-10.916666666666657,10,3
1444,0.0,36,892,856,180.0,1,-84.63888888888887,10,3
1445,0.0,-21,884,905,300.0,1,-100.80555555555553,10,3
1446,1.0,-12,893,905,300.0,0,-64.38888888888887,10,3
1447,1.0,4,901,897,300.0,1,-42.833333333333314,10,3
1448,0.0,-59,894,953,600.0,0,-311.38888888888886,10,3
1449,1.0,49,901,852,300.0,0,-108.63888888888889,11,4
1450,0.0,-107,895,1002,300.0,0,-151.36111111111111,11,4
1451,0.0,-119,889,1008,300.0,1,-72.41666666666666,11,4
1452,0.0,-61,882,943,300.0,1,-116.97222222222221,11,4
1453,1.0,36,890,854,300.0,1,-156.83333333333331,11,4
1454,0.0,-22,882,904,300.0,1,-57.277777777777764,11,4
1455,0.0,2,874,872,300.0,0,-133.02777777777777,11,4
1456,0.0,14,865,851,300.0,1,-142.97222222222223,11,4
1457,0.5,-1,865,866,600.0,0,-231.19444444444443,11,4
1458,0.0,26,856,830,600.0,0,-184.2777777777778,11,4
1459,0.0,30,847,817,600.0,0,-224.22222222222223,11,4
1460,0.0,-24,839,863,300.0,1,-151.72222222222223,12,5
1461,1.0,75,846,771,600.0,0,-132.05555555555557,12,5
1462,1.0,62,853,791,600.0,1,-224.44444444444443,12,5
1463,0.5,44,852,808,180.0,1,-75.30555555555554,12,5
1464,1.0,-8,861,869,600.0,1,-326.77777777777777,12,5
1465,1.0,7,869,862,600.0,0,-290.4444444444444,13,6
1466,0.0,-99,863,962,180.0,0,-68.66666666666664,13,6
1467,1.0,34,871,837,300.0,1,-110.38888888888887,13,6
1468,1.0,59,878,819,300.0,0,-152.77777777777777,13,6
1469,0.0,-19,870,889,600.0,0,-121.1111111111111,13,6
1470,1.0,57,877,820,600.0,0,-62.80555555555554,13,6
1471,1.0,-1,885,886,600.0,1,-328.77777777777777,13,6
1472,0.0,-24,877,901,300.0,0,-93.72222222222221,14,0
1473,0.0,-14,869,883,300.0,1,-120.86111111111111,14,0
1474,0.0,15,860,845,300.0,0,-149.22222222222223,14,0
1475,1.0,96,866,770,180.0,1,-69.74999999999999,14,0
1476,1.0,-2,874,876,180.0,1,-97.69444444444443,14,0
1477,1.0,-82,884,966,300.0,1,-152.52777777777774,14,0
1478,0.0,-31,876,907,600.0,1,-134.44444444444443,14,0
1479,0.0,-5,868,873,600.0,0,-144.33333333333334,15,1
1480,1.0,-11,877,888,600.0,0,-137.86111111111111,15,1
1481,1.0,-3,885,888,180.0,0,-0.05555555555554161,15,1
1482,1.0,128,890,762,180.0,1,-57.777777777777764,15,1
1483,1.0,38,897,859,600.0,0,-157.02777777777774,15,1
1484,0.0,-52,890,942,600.0,0,-251.49999999999997,15,1
1485,0.5,44,889,845,300.0,1,-152.44444444444443,16,2
1486,1.0,63,896,833,600.0,1,-328.91666666666663,16,2
1487,0.0,-13,888,901,300.0,1,-138.61111111111111,16,2
1488,0.0,-51,881,932,180.0,0,-33.444444444444436,16,2
1489,0.0,-13,873,886,300.0,1,-136.97222222222223,16,2
1490,0.0,-28,865,893,600.0,1,-106.6111111111111,16,2
1491,1.0,27,873,846,300.0,0,-103.94444444444443,16,2
1492,0.0,-40,866,906,180.0,0,-33.527777777777764,16,2
1493,0.0,-84,860,944,180.0,0,-90.0833333333333,16,2
1494,1.0,36,868,832,300.0,1,-125.19444444444446,17,3
1495,0.0,-73,861,934,180.0,0,-81.13888888888889,17,3
1496,0.0,-63,854,917,180.0,0,-37.777777777777764,17,3
1497,1.0,-8,863,871,600.0,0,-280.0833333333333,17,3
1498,0.0,61,853,792,600.0,1,-211.08333333333334,18,4
1499,1.0,-59,863,922,300.0,1,-131.4722222222222,18,4
1500,0.0,-41,856,897,600.0,1,-260.77777777777777,18,4
1501,1.0,4,864,860,180.0,0,-18.88888888888888,18,4
1502,1.0,-75,874,949,180.0,1,-98.13888888888887,18,4
1503,0.0,-16,866,882,180.0,1,-88.91666666666666,18,4
1504,0.0,-33,858,891,600.0,0,-199.83333333333331,18,4
1505,1.0,-4,867,871,600.0,0,-258.8333333333333,19,5
1506,1.0,26,875,849,600.0,1,-143.75,19,5
1507,0.0,-88,869,957,300.0,0,-127.94444444444443,19,5
1508,1.0,-15,878,893,300.0,0,-141.66666666666666,19,5
1509,0.0,-70,871,941,600.0,0,-293.77777777777777,19,5
1510,1.0,34,879,845,600.0,1,-317.9444444444444,19,5
1511,0.0,14,870,856,600.0,0,-273.19444444444446,19,5
1512,0.0,5,861,856,600.0,1,-270.02777777777777,19,5
1513,1.0,78,868,790,600.0,1,-95.94444444444443,20,6
1514,1.0,-19,877,896,600.0,0,-244.24999999999997,20,6
1515,0.5,-20,877,897,600.0,1,-219.2777777777778,20,6
1516,0.0,-34,869,903,600.0,1,-235.61111111111111,20,6
1517,0.5,-1,869,870,600.0,0,-91.55555555555554,20,6
1518,1.0,47,876,829,600.0,1,-161.55555555555557,20,6
1519,1.0,-235,889,1124,300.0,0,-15.611111111111095,20,6
1520,0.0,-669,889,1558,300.0,1,-113.7222222222222,20,6
1521,1.0,206,893,687,300.0,0,-133.02777777777777,20,6
1522,0.0,-386,891,1277,300.0,0,-52.99999999999998,20,6
1523,0.0,-163,886,1049,300.0,0,-29.055555555555546,20,6
1524,0.0,-710,886,1596,300.0,1,-127.61111111111109,20,6
1525,0.0,-683,886,1569,300.0,0,-74.05555555555554,20,6
1526,1.0,37,893,856,600.0,1,-188.52777777777777,20,6
1527,1.0,102,899,797,600.0,1,-261.4166666666667,20,6
1528,1.0,64,906,842,600.0,0,-66.1388888888889,21,0
1529,1.0,33,914,881,600.0,1,-275.22222222222223,21,0
1530,0.0,-8,906,914,180.0,1,-91.49999999999999,21,0
1531,1.0,77,913,836,600.0,1,-143.05555555555554,21,0
1532,0.0,-20,905,925,600.0,0,-80.08333333333331,21,0
1533,0.0,-23,897,920,600.0,0,-313.83333333333337,21,0
1534,0.0,-172,893,1065,180.0,0,-92.63888888888887,21,0
1535,0.0,-17,885,902,600.0,1,-229.55555555555554,21,0
1536,1.0,47,892,845,600.0,0,-187.52777777777771,21,0
1537,1.0,44,899,855,600.0,0,-266.3611111111111,22,1
1538,0.0,-51,892,943,600.0,1,-267.5,22,1
1539,1.0,29,900,871,600.0,1,-65.11111111111109,22,1
1540,1.0,31,908,877,600.0,0,-311.61111111111114,22,1
1541,0.0,12,899,887,600.0,1,-271.05555555555554,22,1
1542,0.0,-481,898,1379,180.0,0,-38.83333333333332,22,1
1543,0.0,-561,897,1458,180.0,0,-52.52777777777777,22,1
1544,0.0,-884,897,1781,180.0,1,-63.02777777777776,22,1
1545,0.0,-140,892,1032,180.0,0,-65.52777777777776,22,1
1546,0.0,-62,885,947,600.0,1,-292.52777777777777,23,2
1547,1.0,-12,894,906,600.0,1,-204.36111111111111,23,2
1548,0.0,-234,891,1125,300.0,0,-155.16666666666663,23,2
1549,0.0,-114,885,999,180.0,1,-94.58333333333331,23,2
1550,0.0,-12,877,889,600.0,0,-313.72222222222223,23,2
1551,0.0,-260,874,1134,180.0,1,-78.25,23,2
1552,0.0,-888,874,1762,180.0,0,-85.05555555555554,23,2
1553,0.0,-214,870,1084,180.0,0,-96.47222222222221,23,2
1554,1.0,217,876,659,600.0,0,-78.30555555555554,23,2
1555,1.0,-21,885,906,600.0,1,-330.75,23,2
1556,0.5,-95,887,982,300.0,0,-155.55555555555554,24,3
1557,1.0,7,895,888,600.0,0,-14.55555555555554,24,3
1558,1.0,-2,903,905,600.0,1,-286.08333333333337,24,3
1559,1.0,-29,912,941,600.0,1,-264.9166666666667,24,3
1560,1.0,56,919,863,600.0,1,-309.0833333333333,24,3
1561,0.5,24,918,894,600.0,0,-318.13888888888886,25,4
1562,1.0,25,926,901,300.0,1,-79.49999999999999,25,4
1563,1.0,-51,936,987,600.0,0,-207.80555555555551,25,4
1564,0.0,-6,928,934,600.0,1,-316.5,25,4
1565,0.0,-35,920,955,300.0,0,-125.16666666666666,26,5
1566,1.0,16,928,912,600.0,0,-291.47222222222223,26,5
1567,0.0,0,920,920,600.0,1,-187.83333333333331,26,5
1568,0.0,-21,912,933,600.0,0,-258.25,26,5
1569,1.0,92,918,826,600.0,1,-138.2222222222222,27,6
1570,1.0,16,926,910,600.0,0,-240.19444444444446,27,6
1571,1.0,37,933,896,600.0,1,-225.94444444444443,27,6
1572,0.0,-34,925,959,600.0,1,-326.0555555555556,27,6
1573,0.0,-37,918,955,600.0,1,-176.47222222222217,29,1
1574,0.0,2,910,908,600.0,0,-233.69444444444443,30,2
1575,0.0,0,902,902,600.0,1,-199.80555555555554,1,4
1576,1.0,22,910,888,600.0,0,-142.08333333333334,2,5
1577,0.0,-44,903,947,600.0,0,-246.55555555555554,2,5
1578,0.0,30,894,864,600.0,0,-162.80555555555551,2,5
1579,1.0,-13,903,916,600.0,1,-214.30555555555551,2,5
1580,1.0,38,911,873,600.0,1,-304.69444444444446,3,6
1581,1.0,85,917,832,600.0,0,-226.88888888888886,3,6
1582,0.0,-36,909,945,600.0,0,-254.0,3,6
1583,0.0,-40,902,942,600.0,1,-267.02777777777777,3,6
1584,1.0,10,910,900,600.0,1,-42.91666666666666,4,0
1585,0.0,29,901,872,300.0,0,-132.33333333333331,4,0
1586,0.0,-61,894,955,600.0,0,-301.5833333333333,4,0
1587,1.0,-13,903,916,600.0,1,-215.13888888888889,5,1
1588,0.0,26,894,868,600.0,1,-101.58333333333331,5,1
1589,1.0,-76,904,980,600.0,0,-50.4722222222222,5,1
1590,1.0,76,911,835,600.0,0,-293.63888888888886,5,1
1591,0.0,-52,904,956,300.0,1,-116.38888888888889,6,2
1592,0.0,-64,897,961,600.0,0,-324.9444444444444,6,2
1593,1.0,2,906,904,600.0,1,-145.02777777777777,7,3
1594,0.0,-60,899,959,600.0,0,-153.41666666666666,7,3
1595,1.0,29,907,878,600.0,1,-108.69444444444443,7,3
1596,1.0,29,915,886,600.0,0,-141.66666666666663,7,3
1597,0.0,-31,907,938,600.0,1,-313.3055555555556,7,3
1598,1.0,-26,916,942,600.0,1,-192.47222222222217,7,3
1599,0.0,-29,908,937,180.0,1,-81.30555555555556,8,4
1600,1.0,76,915,839,600.0,0,-283.6944444444444,8,4
1601,0.0,-24,907,931,600.0,0,-162.05555555555551,8,4
1602,1.0,51,914,863,600.0,1,-136.69444444444446,9,5
1603,1.0,15,922,907,600.0,0,-247.08333333333331,9,5
1604,0.0,-19,914,933,600.0,1,-250.3611111111111,10,6
1605,1.0,-10,923,933,600.0,0,-123.91666666666666,10,6
1606,0.0,-40,916,956,600.0,0,-254.02777777777774,10,6
1607,0.0,41,907,866,600.0,0,-229.24999999999994,11,0
1608,1.0,48,914,866,600.0,1,-243.02777777777777,11,0
1609,1.0,8,922,914,600.0,0,-331.05555555555554,12,1
1610,0.0,-34,914,948,600.0,1,-249.16666666666663,12,1
1611,1.0,58,921,863,600.0,1,-139.02777777777774,12,1
1612,0.0,-75,914,989,600.0,1,-194.99999999999997,13,2
1613,0.0,70,904,834,600.0,1,-55.8611111111111,13,2
1614,1.0,158,909,751,600.0,0,-104.49999999999999,13,2
1615,0.0,-15,901,916,600.0,0,-298.13888888888886,13,2
1616,0.5,-27,902,929,600.0,1,-227.77777777777777,14,3
1617,1.0,-11,911,922,600.0,0,-195.99999999999997,14,3
1618,0.0,32,902,870,600.0,0,-249.80555555555551,14,3
1619,0.0,-63,895,958,600.0,1,-151.94444444444443,15,4
1620,1.0,29,903,874,600.0,1,-27.9444444444444,15,4
1621,0.0,-63,896,959,600.0,0,-228.86111111111106,15,4
1622,1.0,51,903,852,600.0,0,-300.4722222222222,15,4
1623,1.0,-20,912,932,600.0,1,-52.36111111111109,16,5
1624,1.0,41,919,878,600.0,1,-156.88888888888889,16,5
1625,1.0,57,926,869,600.0,0,-148.5277777777778,17,6
1626,1.0,71,933,862,600.0,1,-311.47222222222223,17,6
1627,0.0,43,924,881,600.0,0,-169.7777777777778,17,6
1628,1.0,11,932,921,600.0,1,-60.08333333333332,17,6
1629,0.0,-75,925,1000,600.0,0,-322.5,17,6
1630,0.0,-59,918,977,600.0,1,-304.6111111111111,17,6
1631,0.0,17,909,892,600.0,0,-247.72222222222217,17,6
1632,1.0,24,917,893,300.0,1,-164.22222222222223,18,0
1633,1.0,-24,926,950,600.0,1,-89.69444444444444,18,0
1634,1.0,45,933,888,600.0,0,-1.611111111111114,18,0
1635,1.0,-34,942,976,600.0,1,-190.66666666666663,18,0
1636,1.0,-2,950,952,600.0,1,-250.4722222222222,18,0
1637,0.0,18,941,923,600.0,0,-167.02777777777777,19,1
1638,0.0,56,931,875,600.0,0,-208.86111111111114,19,1
1639,1.0,-53,941,994,600.0,0,-70.05555555555554,19,1
1640,1.0,72,948,876,600.0,1,-164.38888888888886,19,1
1641,0.0,-23,940,963,600.0,0,-238.24999999999997,19,1
1642,0.5,-58,941,999,600.0,0,-195.13888888888886,19,1
1643,0.5,-14,941,955,300.0,1,-162.8055555555555,19,1
1644,0.0,-33,933,966,600.0,1,-86.1111111111111,20,2
1645,1.0,32,941,909,600.0,1,-202.30555555555551,20,2
1646,0.0,-37,934,971,600.0,1,-158.8333333333333,20,2
1647,1.0,82,940,858,300.0,0,-163.1111111111111,20,2
1648,0.0,-63,933,996,600.0,0,-181.83333333333331,21,3
1649,0.0,8,924,916,600.0,0,-3.694444444444418,22,4
1650,0.0,32,915,883,600.0,1,-64.99999999999999,22,4
1651,0.0,-34,907,941,600.0,1,-309.25,22,4
1652,0.0,29,898,869,600.0,0,-277.3611111111111,23,5
1653,0.0,-6,890,896,600.0,0,-158.11111111111111,23,5
1654,0.0,51,880,829,300.0,1,-139.22222222222223,23,5
1655,1.0,61,887,826,600.0,0,-86.3611111111111,23,5
1656,1.0,59,894,835,600.0,1,-303.02777777777777,23,5
1657,1.0,-12,903,915,600.0,0,-42.36111111111108,23,5
1658,1.0,29,911,882,600.0,1,-161.77777777777777,23,5
1659,1.0,2,919,917,600.0,0,-325.52777777777777,23,5
1660,0.0,-176,914,1090,300.0,1,-85.55555555555554,23,5
1661,0.0,27,905,878,300.0,0,-4.305555555555538,23,5
1662,0.0,-36,897,933,300.0,0,-99.91666666666664,23,5
1663,1.0,-30,906,936,600.0,1,-113.88888888888887,24,6
1664,1.0,6,914,908,600.0,0,-163.08333333333331,24,6
1665,1.0,14,922,908,600.0,1,-129.11111111111111,24,6
1666,0.0,-27,914,941,600.0,0,-130.6111111111111,24,6
1667,1.0,10,922,912,600.0,1,-118.66666666666666,24,6
1668,0.0,10,913,903,600.0,0,-97.33333333333331,24,6
1669,1.0,11,921,910,600.0,1,-97.83333333333331,24,6
1670,0.0,20,912,892,600.0,1,-196.83333333333331,24,6
1671,0.5,18,912,894,600.0,1,-256.75,24,6
1672,0.0,28,903,875,600.0,0,-314.25,24,6
1673,1.0,-21,912,933,600.0,0,-286.27777777777777,25,0
1674,1.0,36,919,883,600.0,1,-230.38888888888886,25,0
1675,0.0,-62,912,974,600.0,0,-161.9722222222222,25,0
1676,0.0,-27,904,931,600.0,0,-330.0833333333333,26,1
1677,0.0,-41,897,938,600.0,0,-152.44444444444443,27,2
1678,0.0,-17,889,906,600.0,1,-237.49999999999997,27,2
1679,0.0,40,880,840,600.0,0,-279.47222222222223,27,2
1680,1.0,-18,889,907,600.0,1,-116.58333333333333,28,3
1681,0.0,21,880,859,600.0,1,-233.75,28,3
1682,1.0,-17,889,906,600.0,0,-171.27777777777774,28,3
1683,0.0,-97,883,980,300.0,1,-165.44444444444443,29,4
1684,1.0,-46,892,938,600.0,1,-257.66666666666663,29,4
1685,0.5,-56,893,949,600.0,1,-198.97222222222217,29,4
1686,1.0,65,900,835,600.0,1,-38.91666666666666,29,4
1687,0.0,8,891,883,600.0,0,-256.52777777777777,29,4
1688,0.5,-12,891,903,600.0,0,-251.38888888888889,30,5
1689,1.0,150,896,746,600.0,0,-170.19444444444446,30,5
1690,0.0,-55,889,944,600.0,1,-153.69444444444443,30,5
1691,1.0,-16,898,914,600.0,0,-141.9722222222222,30,5
1692,0.0,-1,890,891,600.0,0,-83.58333333333333,30,5
1693,1.0,24,898,874,600.0,1,-75.33333333333331,30,5
1694,0.0,-60,891,951,300.0,1,-123.38888888888887,30,5
1695,1.0,-15,900,915,600.0,1,-101.97222222222223,1,6
1696,1.0,-2,908,910,180.0,0,-48.41666666666666,1,6
1697,0.0,19,899,880,180.0,1,-83.33333333333331,2,0
1698,0.0,18,890,872,180.0,1,-94.02777777777776,2,0
1699,1.0,23,898,875,600.0,0,-248.69444444444443,2,0
1700,0.0,66,888,822,600.0,1,-202.66666666666663,2,0
1701,0.0,-34,880,914,600.0,0,-168.52777777777777,2,0
1702,1.0,62,887,825,300.0,0,-137.58333333333334,3,1
1703,0.0,-54,880,934,600.0,0,-264.83333333333337,3,1
1704,0.0,13,871,858,600.0,1,-214.30555555555551,3,1
1705,0.0,15,862,847,600.0,0,-252.0,4,2
1706,1.0,41,869,828,600.0,0,-240.86111111111111,4,2
1707,1.0,-30,878,908,600.0,1,-31.611111111111114,4,2
1708,1.0,150,883,733,600.0,1,-152.52777777777774,4,2
1709,1.0,49,890,841,600.0,1,-292.30555555555554,4,2
1710,1.0,39,897,858,600.0,1,-163.4722222222222,4,2
1711,1.0,65,904,839,600.0,1,-263.19444444444446,4,2
1712,1.0,4,912,908,600.0,0,-50.888888888888864,4,2
1713,1.0,-21,921,942,600.0,0,-258.55555555555554,5,3
1714,0.0,-98,915,1013,600.0,0,-214.74999999999997,5,3
1715,1.0,73,922,849,600.0,1,-258.83333333333337,5,3
1716,0.0,-50,915,965,180.0,0,-64.33333333333333,6,4
1717,1.0,26,923,897,600.0,0,-239.2777777777778,6,4
1718,1.0,24,931,907,600.0,0,-169.97222222222217,6,4
1719,1.0,9,939,930,600.0,1,-120.9722222222222,6,4
1720,0.0,24,930,906,600.0,1,-125.44444444444441,6,4
1721,1.0,39,937,898,600.0,1,-270.66666666666663,7,5
1722,0.0,-55,930,985,600.0,1,-84.30555555555554,7,5
1723,1.0,-11,939,950,600.0,1,-25.38888888888887,8,6
1724,0.0,31,930,899,600.0,1,-137.77777777777777,8,6
1725,1.0,-32,939,971,600.0,0,-219.33333333333334,8,6
1726,1.0,60,946,886,600.0,0,-237.99999999999997,8,6
1727,0.0,31,937,906,600.0,0,-60.99999999999999,8,6
1728,0.0,-52,930,982,600.0,1,-316.1944444444445,8,6
1729,0.0,-6,922,928,600.0,0,-223.3333333333333,8,6
1730,0.0,-37,915,952,600.0,1,-226.27777777777777,9,0
1731,1.0,34,923,889,300.0,0,-55.527777777777764,9,0
1732,1.0,52,930,878,600.0,1,-236.88888888888886,10,1
1733,1.0,-9,939,948,600.0,0,-90.55555555555554,10,1
1734,0.0,-154,934,1088,600.0,1,-325.0,10,1
1735,1.0,20,942,922,600.0,1,-172.08333333333334,11,2
1736,0.0,-40,935,975,600.0,1,-242.66666666666666,11,2
1737,1.0,15,943,928,600.0,0,-180.13888888888886,11,2
1738,0.0,-44,936,980,600.0,0,-186.8611111111111,11,2
1739,0.0,39,927,888,180.0,1,-85.69444444444443,12,3
1740,1.0,43,934,891,600.0,1,-325.22222222222223,12,3
1741,0.0,0,926,926,600.0,0,-155.44444444444443,12,3
1742,0.0,2,918,916,600.0,0,-147.41666666666666,12,3
1743,1.0,48,925,877,600.0,0,-194.11111111111106,12,3
1744,1.0,-40,934,974,600.0,1,-275.5,13,4
1745,0.0,29,925,896,600.0,1,-288.77777777777777,13,4
1746,1.0,8,933,925,600.0,1,-101.99999999999999,13,4
1747,0.5,7,933,926,300.0,0,-118.86111111111109,13,4
1748,0.0,-49,926,975,300.0,0,-119.30555555555554,13,4
1749,0.0,-28,918,946,600.0,1,-292.3611111111111,13,4
1750,0.0,-65,911,976,300.0,1,-133.83333333333334,14,5
1751,1.0,-1,919,920,300.0,1,-136.63888888888889,14,5
1752,1.0,1,927,926,600.0,0,-231.66666666666666,14,5
1753,0.5,-545,934,1479,300.0,0,-144.86111111111111,14,5
1754,1.0,343,936,593,300.0,0,-112.9722222222222,14,5
1755,0.0,-600,935,1535,300.0,1,-90.8611111111111,14,5
1756,1.0,141,942,801,300.0,0,-132.08333333333334,14,5
1757,1.0,-339,956,1295,300.0,1,-165.16666666666666,14,5
1758,0.0,-682,956,1638,300.0,0,-49.13888888888887,14,5
1759,0.0,-102,950,1052,300.0,1,-87.83333333333333,14,5
1760,1.0,300,953,653,300.0,0,-109.58333333333331,14,5
1761,0.0,-385,951,1336,300.0,0,-110.08333333333331,14,5
1762,0.0,-408,950,1358,300.0,1,-124.6111111111111,14,5
1763,0.0,-343,948,1291,300.0,0,-141.52777777777777,14,5
1764,0.0,-695,961,1656,300.0,1,-98.24999999999999,14,5
1765,1.0,38,969,931,600.0,0,-64.69444444444444,15,6
1766,0.0,17,960,943,600.0,1,-245.38888888888889,15,6
1767,0.0,-24,952,976,600.0,0,-278.47222222222223,15,6
1768,1.0,-4,961,965,600.0,1,-28.722222222222204,15,6
1769,0.0,22,952,930,600.0,1,-29.055555555555518,15,6
1770,1.0,44,959,915,600.0,0,-187.33333333333331,15,6
1771,1.0,39,966,927,600.0,1,-135.47222222222223,15,6
1772,1.0,-16,975,991,600.0,0,-197.63888888888889,16,0
1773,1.0,-47,985,1032,600.0,0,-82.0,16,0
1774,0.0,-8,977,985,600.0,1,-204.58333333333331,16,0
1775,0.0,-65,970,1035,600.0,1,-180.38888888888889,16,0
1776,0.0,35,961,926,600.0,0,-289.05555555555554,16,0
1777,1.0,2,969,967,600.0,1,-156.2222222222222,16,0
1778,0.0,-26,961,987,300.0,1,-134.13888888888886,16,0
1779,0.0,-25,953,978,600.0,1,-188.88888888888886,16,0
1780,0.0,-44,946,990,600.0,0,-285.22222222222223,17,1
1781,0.0,-21,938,959,600.0,1,-278.1666666666667,17,1
1782,1.0,11,946,935,600.0,0,-229.69444444444443,17,1
1783,1.0,10,954,944,600.0,0,-283.80555555555554,17,1
1784,1.0,-16,963,979,300.0,0,-152.55555555555557,18,2
1785,1.0,45,970,925,600.0,1,-49.527777777777764,18,2
1786,1.0,37,978,941,300.0,0,-164.11111111111106,18,2
1787,1.0,94,984,890,600.0,0,-122.47222222222221,18,2
1788,0.0,-60,977,1037,600.0,1,-284.72222222222223,19,3
1789,1.0,44,984,940,600.0,1,-54.11111111111111,19,3
1790,0.5,17,984,967,600.0,1,-245.5277777777778,19,3
1791,0.0,-65,977,1042,600.0,0,-204.63888888888889,19,3
1792,1.0,37,984,947,600.0,0,-198.9722222222222,19,3
1793,1.0,37,991,954,600.0,0,-253.8611111111111,20,4
1794,0.0,-57,984,1041,600.0,0,-287.19444444444446,20,4
1795,0.0,22,975,953,300.0,1,-114.83333333333331,20,4
1796,0.0,-56,968,1024,600.0,0,-280.08333333333337,20,4
1797,1.0,52,975,923,600.0,1,-141.27777777777777,20,4
1798,0.0,429,960,531,300.0,0,-136.74999999999997,20,4
1799,1.0,212,964,752,300.0,1,-124.99999999999999,20,4
1800,0.0,105,953,848,300.0,1,-154.61111111111111,20,4
1801,0.0,-251,950,1201,300.0,1,-96.63888888888887,20,4
1802,0.0,-1,942,943,300.0,1,-146.2222222222222,21,5
1803,1.0,71,949,878,600.0,0,-253.41666666666666,21,5
1804,0.0,-41,942,983,600.0,0,-101.02777777777776,21,5
1805,0.0,-41,935,976,600.0,0,-285.27777777777777,21,5
1806,0.5,14,935,921,300.0,1,-134.6944444444444,21,5
1807,1.0,58,942,884,600.0,0,-203.99999999999997,21,5
1808,1.0,-9,951,960,600.0,0,-122.55555555555556,22,6
1809,1.0,54,959,905,600.0,1,-228.7222222222222,22,6
